0,0,0,0,0,0,0,0,0,0,0,0,0,0,0,0,0,0,0,0,0,0,0,0,0,0,0,0,0,0,0,0,0,0,0,0,0,0,0,0,0,0,0,0,0,0,0,0,0,0,0,0,0,0,0,0,0,0,0,0,0,0,0,0,0,0,0,0,0,0,0,0,0,0,0,0,0,0,0,0,0,0,0,0,0,0,0,0,0,0,0,0,0,0,0,0,0,0,0,0
0,0,0,0,0,0,0,0,0,0,0,0,0,0,0,0,0,0,0,0,0,0,0,0,0,0,0,0,0,0,0,0,0,0,0,0,0,0,0,0,0,0,0,0,0,0,0,0,0,0,0,0,0,0,0,0,0,0,0,0,0,0,0,0,0,0,0,0,0,0,0,0,0,0,0,0,0,0,0,0,0,0,0,0,0,0,0,0,0,0,0,0,0,0,0,0,0,0,0,0
0,0,0,0,0,0,0,0,0,0,0,0,0,0,0,0,0,0,0,0,0,0,0,0,0,0,0,0,0,0,0,0,0,0,0,0,0,0,0,0,0,0,0,0,0,0,0,0,0,0,0,0,0,0,0,0,0,0,0,0,0,0,0,0,0,0,0,0,0,0,0,0,0,0,0,0,0,0,0,0,0,0,0,0,0,0,0,0,0,0,0,0,0,0,0,0,0,0,0,0
0,0,0,0,0,0,0,0,0,0,0,0,0,0,0,0,0,0,0,0,0,0,0,0,0,0,0,0,0,0,0,0,0,0,0,0,0,0,0,0,0,0,0,0,0,0,0,0,0,0,0,0,0,0,0,0,0,0,0,0,0,0,0,0,0,0,0,0,0,0,0,0,0,0,0,0,0,0,0,0,0,0,0,0,0,0,0,0,0,0,0,0,0,0,0,0,0,0,0,0
0,0,0,0,0,0,0,0,0,0,2,5,4,1,0,0,0,0,0,0,0,0,0,0,0,0,0,0,0,0,0,0,0,0,0,0,0,0,0,0,0,0,0,0,0,0,0,0,0,0,0,0,0,0,0,0,0,0,0,0,0,0,0,0,0,0,0,0,0,0,0,0,0,0,0,0,0,0,0,0,0,0,0,0,0,0,0,0,0,0,0,0,0,0,0,0,0,0,0,0
0,0,0,0,0,0,0,0,0,0,3,13,25,28,17,5,0,0,0,0,0,0,0,0,0,0,0,0,0,0,0,0,0,0,0,0,0,0,0,0,0,0,0,0,0,0,0,0,0,0,0,0,0,0,0,0,0,0,0,0,0,0,0,0,0,0,0,0,0,0,0,0,0,0,0,0,0,0,0,0,0,0,0,0,0,0,0,0,0,0,0,0,0,0,0,0,0,0,0,0
0,0,0,0,0,0,0,0,0,0,2,15,33,41,30,27,27,15,1,0,0,0,0,0,0,0,0,0,0,0,0,0,0,0,0,0,0,0,0,0,0,0,0,0,0,0,0,0,0,0,0,0,0,0,0,0,0,0,0,0,0,0,0,0,0,0,0,0,0,0,0,0,0,0,0,0,0,0,0,0,0,0,0,0,0,0,0,0,0,0,0,0,0,0,0,0,0,0,0,0
0,0,0,0,0,0,0,0,0,0,0,6,18,25,21,35,42,33,10,6,3,0,0,0,0,0,0,0,0,0,0,0,0,0,0,0,0,0,0,0,0,0,0,0,0,0,0,0,0,0,0,0,0,0,0,0,0,0,0,0,0,0,0,0,0,0,0,0,0,0,0,0,0,0,0,0,0,0,0,0,0,0,0,0,0,0,0,0,0,0,0,0,0,0,0,0,0,0,0,0
0,0,0,0,0,0,0,0,0,0,0,0,0,0,2,17,30,25,14,11,8,5,4,3,0,0,0,0,0,0,0,0,0,0,0,0,0,0,0,0,0,0,0,0,0,0,6,11,6,0,0,0,0,0,0,0,0,0,0,0,0,0,0,0,0,0,0,0,0,0,0,0,0,1,2,2,0,0,0,0,0,0,0,0,0,0,0,0,0,0,0,0,0,0,0,0,0,0,0,0
0,0,0,0,0,0,0,0,0,0,0,0,0,0,0,0,2,5,8,8,7,7,7,6,4,3,2,1,0,0,0,0,0,0,0,0,0,0,0,0,0,0,0,0,0,0,13,23,28,20,10,1,0,0,0,0,0,0,0,0,0,0,0,0,0,0,0,0,0,0,0,0,0,3,5,4,1,0,0,0,0,0,0,0,0,0,0,0,0,0,0,0,0,0,0,0,0,0,0,0
0,0,0,0,0,0,0,0,0,0,0,0,0,0,0,0,0,0,0,0,2,4,5,6,5,6,10,15,13,6,2,0,0,0,0,0,0,0,0,0,0,0,0,0,0,0,9,22,34,32,29,23,16,4,0,0,0,0,0,0,0,0,0,0,0,0,0,0,0,0,0,0,1,3,5,3,0,0,0,2,3,1,0,0,0,0,0,0,0,0,0,0,0,0,0,0,0,0,0,0
0,0,0,0,0,0,0,0,0,0,0,0,0,0,0,0,0,0,0,0,0,0,0,1,3,3,13,21,22,12,8,5,3,0,0,0,0,0,0,0,0,0,0,0,0,0,2,7,17,23,30,36,34,17,5,1,0,0,0,0,0,0,0,0,0,0,0,0,0,0,0,0,2,6,7,3,0,0,0,4,6,4,0,0,0,0,0,0,0,0,0,0,0,0,0,0,0,0,0,0
0,0,0,0,0,0,0,0,0,0,0,0,0,0,0,0,0,0,0,0,0,0,0,0,0,0,6,13,13,10,9,9,6,5,4,2,0,0,0,0,0,0,0,0,0,0,0,0,0,1,11,27,29,20,11,7,4,2,0,0,0,0,0,0,0,0,0,0,0,0,0,1,3,10,13,9,1,0,0,3,7,6,1,0,0,0,0,0,0,0,0,0,0,0,0,0,0,0,0,0
0,0,0,0,0,0,0,0,0,0,0,0,0,0,0,0,0,0,0,0,0,0,0,0,0,0,0,0,0,2,5,6,6,6,6,6,4,3,1,0,0,0,0,0,0,0,0,0,0,0,0,3,8,10,9,9,8,6,4,2,0,0,0,0,0,0,0,0,0,0,0,2,4,8,14,12,4,0,0,1,5,6,3,0,0,0,0,0,0,0,0,0,0,0,0,0,0,0,0,0
0,0,0,0,0,0,0,0,0,0,0,0,0,0,0,0,0,0,0,0,0,0,0,0,0,0,0,0,0,0,0,0,1,3,4,5,5,5,4,4,2,0,0,0,0,0,0,0,0,0,0,0,0,0,2,4,6,6,6,6,4,3,1,0,0,0,0,0,0,0,1,4,4,3,8,10,5,0,0,0,3,6,5,0,0,0,0,0,0,0,0,0,0,0,0,0,0,0,0,0
0,0,0,0,0,0,0,0,0,0,0,0,0,0,0,0,0,0,0,0,0,0,0,0,0,0,0,0,0,0,0,0,0,0,0,1,3,3,4,5,4,3,3,2,0,0,0,0,0,0,0,0,0,0,0,0,0,2,4,5,5,8,11,9,2,0,0,0,0,0,4,6,4,0,5,9,5,0,0,0,1,5,5,2,0,0,0,0,0,0,0,0,0,0,0,0,0,0,0,0
0,0,0,0,0,0,0,0,0,0,0,0,0,0,0,0,0,0,0,0,0,0,0,0,0,0,0,0,0,0,0,0,0,0,0,0,0,0,1,3,4,4,5,4,4,3,2,0,0,0,0,0,0,0,0,0,0,0,0,1,3,9,18,18,7,0,0,0,0,4,8,7,2,0,5,8,5,0,0,0,0,4,6,4,0,0,0,0,0,0,0,0,0,0,0,0,0,0,0,0
0,0,0,0,0,0,0,0,0,0,0,0,0,0,0,0,0,0,0,0,0,0,0,0,0,0,0,0,0,0,0,0,0,0,0,0,0,0,0,0,0,2,3,4,4,4,4,4,3,1,0,0,0,0,0,0,0,0,0,0,0,3,15,19,11,0,0,2,5,11,13,10,7,7,11,11,6,0,0,0,0,4,6,4,0,0,0,0,0,0,0,0,0,0,0,0,0,0,0,0
0,0,0,0,0,0,0,0,0,0,0,0,0,0,0,0,0,0,0,0,0,0,0,0,0,0,0,0,0,0,0,0,0,0,0,0,0,0,0,0,0,0,0,1,2,3,3,4,5,4,3,2,1,0,0,0,0,0,0,0,0,0,6,13,13,7,7,12,15,16,15,12,11,12,17,19,14,7,5,4,4,5,5,4,0,0,0,0,0,0,0,0,0,0,0,0,0,0,0,0
0,0,0,0,0,0,0,0,0,0,0,0,0,0,0,0,0,0,0,0,0,0,0,0,0,0,0,0,0,0,0,0,0,0,0,0,0,0,2,7,11,11,8,10,14,11,6,7,11,17,21,19,13,9,8,6,6,5,4,3,3,3,6,13,17,18,27,33,25,12,9,8,8,9,15,19,17,11,8,8,9,9,9,7,3,0,0,0,0,0,0,0,0,0,0,0,0,0,0,0
0,0,0,0,0,0,0,0,0,0,0,0,0,0,0,0,0,0,0,0,0,0,0,0,0,0,0,0,0,0,0,0,0,0,0,0,0,0,4,11,18,18,13,17,21,19,9,7,12,22,30,26,19,14,12,10,9,9,8,8,8,8,7,10,14,19,33,35,21,4,2,1,1,1,5,10,11,7,6,6,9,11,14,11,6,2,1,0,4,8,4,0,0,0,0,0,0,0,0,0
0,0,0,0,0,0,0,0,0,0,0,0,0,0,0,0,0,0,0,0,0,0,0,0,0,0,0,0,0,0,0,0,0,0,0,0,0,0,2,7,11,11,8,10,14,11,6,4,7,12,17,15,10,8,8,6,6,6,6,8,8,6,5,5,6,8,16,17,8,0,0,0,0,0,0,3,4,2,0,1,3,8,14,13,7,3,3,3,12,16,10,0,0,0,0,0,0,0,0,0
0,0,0,0,0,0,0,0,0,0,0,0,0,0,0,0,0,0,0,0,0,0,0,0,0,0,0,0,0,0,0,0,0,0,0,0,0,0,0,0,0,0,0,0,0,0,0,0,0,0,0,0,0,0,0,0,0,0,1,3,3,1,0,0,0,0,0,0,0,0,0,0,0,0,0,3,4,3,0,0,0,3,10,12,6,1,3,3,14,20,12,0,0,0,0,0,0,0,0,0
0,0,0,0,0,0,0,0,0,0,0,0,0,0,0,0,0,0,0,0,0,0,0,0,0,0,0,0,0,0,0,0,0,0,0,0,0,0,0,0,0,0,0,0,0,0,0,0,0,0,0,0,0,0,0,0,0,0,0,0,0,0,0,0,0,0,0,0,0,0,0,0,0,0,0,3,4,3,0,0,0,0,8,12,7,0,0,1,10,14,10,1,0,0,0,0,0,0,0,0
0,0,0,0,0,0,0,0,0,0,0,0,0,0,0,0,0,0,0,0,0,0,0,0,0,0,0,0,0,0,0,0,0,0,0,0,0,0,0,0,0,0,0,0,0,0,0,0,0,0,0,0,0,0,0,0,0,0,0,0,0,0,0,0,0,0,0,0,0,0,0,0,0,0,0,3,4,3,0,0,0,0,6,11,8,1,0,0,6,11,9,3,2,0,0,0,0,0,0,0
0,0,0,0,0,0,0,0,0,0,0,0,0,0,0,0,0,0,0,0,0,0,0,0,0,0,0,0,0,0,0,0,0,0,0,0,0,0,0,0,0,0,0,0,0,0,0,0,0,0,0,0,0,0,0,0,0,0,0,0,0,0,0,0,0,0,0,0,0,0,0,0,0,0,0,3,4,3,0,0,0,0,4,10,9,3,0,0,5,8,7,3,3,2,0,0,0,0,0,0
0,0,0,0,0,0,0,0,0,0,0,0,0,0,0,0,0,0,0,0,0,0,0,0,0,0,0,0,0,0,0,0,0,0,0,0,0,0,0,0,0,0,0,0,0,0,0,0,0,0,0,0,0,0,0,0,0,0,0,0,0,0,0,0,0,0,0,0,0,0,0,0,0,0,0,2,4,3,0,0,0,0,3,8,9,4,0,0,4,7,4,1,3,3,2,0,0,0,0,0
0,0,0,0,0,0,0,0,0,0,0,0,0,0,0,0,0,0,0,0,0,0,0,0,0,0,0,0,0,0,0,0,0,0,0,0,0,0,0,0,0,0,0,0,0,0,0,0,0,0,0,0,0,0,0,0,0,0,0,0,0,0,0,0,0,0,0,0,0,0,0,0,0,0,0,1,3,3,1,0,0,0,3,8,8,4,0,0,3,6,3,0,0,2,3,2,0,0,0,0
0,0,0,0,0,0,0,0,0,0,0,0,0,0,0,0,0,0,0,0,0,0,0,0,0,0,0,0,0,0,0,0,0,0,0,0,0,0,0,0,0,0,0,0,0,0,0,0,0,0,0,0,0,0,0,0,0,0,0,0,0,0,0,0,0,0,0,0,0,0,0,0,0,0,0,0,2,3,1,0,0,0,2,6,8,5,1,0,3,5,3,0,0,0,2,3,2,0,0,0
0,0,0,0,0,0,0,0,0,0,0,0,0,0,0,0,0,0,0,0,0,0,0,0,0,0,0,0,0,0,0,0,0,0,0,0,0,0,0,0,0,0,0,0,0,0,0,0,0,0,0,0,0,0,0,0,0,0,0,0,0,0,0,0,0,0,0,0,0,0,0,0,0,0,0,0,2,3,2,0,0,0,0,4,8,7,2,0,3,6,3,0,0,0,0,3,4,2,0,0
0,0,0,0,0,0,0,0,0,0,0,0,0,0,0,0,0,0,0,0,0,0,0,0,0,0,0,0,0,0,0,0,0,0,0,0,0,0,0,0,0,0,0,0,0,0,0,0,0,0,0,0,0,0,0,0,0,0,0,0,0,0,0,0,0,0,0,0,0,0,0,0,0,0,0,0,2,3,2,0,0,0,0,3,8,8,3,0,3,5,3,0,0,0,0,2,4,2,0,0
0,0,0,0,0,0,0,0,0,0,0,0,0,0,0,0,0,0,0,0,0,0,0,0,0,0,0,0,0,0,0,0,0,0,0,0,0,0,0,0,0,0,0,0,0,0,0,0,0,0,0,0,0,0,0,0,0,0,0,0,0,0,0,0,0,0,0,0,0,0,0,0,0,0,0,0,2,3,2,0,0,0,0,3,8,8,3,0,3,5,3,0,0,0,0,2,3,2,0,0
0,0,0,0,0,0,0,0,0,0,0,0,0,0,0,0,0,0,0,0,0,0,0,0,0,0,0,0,0,0,0,0,0,0,0,0,0,0,0,0,0,0,0,0,0,0,0,0,0,0,0,0,0,0,0,0,0,0,0,0,0,0,0,0,0,0,0,0,0,0,0,0,0,0,0,0,1,3,2,0,0,0,0,3,6,6,1,0,3,4,3,0,0,0,0,2,4,2,0,0
0,0,0,0,0,0,0,0,0,0,1,5,10,11,5,0,0,0,0,0,0,0,0,0,0,0,0,0,0,0,0,0,0,0,0,0,0,0,0,0,0,0,0,0,0,0,0,0,0,0,0,0,0,0,0,0,0,0,0,0,0,0,0,0,0,0,0,0,0,0,0,0,0,0,0,0,1,2,2,1,0,0,0,3,5,3,0,0,3,4,3,0,0,0,0,2,4,2,0,0
0,0,0,0,0,0,0,0,0,0,2,8,17,19,13,10,14,10,3,0,0,0,0,0,0,0,0,0,0,0,0,0,0,0,0,0,0,0,0,0,0,0,0,0,0,0,0,0,0,0,0,0,0,0,0,0,0,0,0,0,0,0,0,0,0,0,0,0,0,0,0,0,0,0,0,0,0,2,3,1,0,0,0,3,4,3,0,0,2,4,2,0,0,0,0,2,3,2,0,0
0,0,0,0,0,0,0,0,0,0,1,5,10,14,12,18,21,18,7,5,9,18,17,10,6,4,4,3,2,1,0,0,0,0,0,0,0,0,0,0,0,0,0,0,0,0,2,6,6,4,8,12,9,3,0,0,0,0,0,0,0,0,0,0,0,0,0,0,0,0,0,0,0,0,0,0,0,2,3,2,0,0,0,3,4,3,0,0,2,3,2,0,0,0,0,2,4,2,0,0
0,0,0,0,0,0,0,0,0,0,0,0,0,2,4,10,14,11,7,6,16,27,28,17,10,7,6,5,4,3,3,3,2,2,2,2,2,1,1,1,0,0,0,0,0,0,4,12,17,14,16,19,16,8,5,4,2,0,0,0,0,0,0,0,0,0,0,0,0,0,0,0,0,0,0,0,0,1,3,1,0,0,0,2,4,3,0,0,2,4,2,0,0,0,0,2,4,2,0,0
0,0,0,0,0,0,0,0,0,0,0,0,0,0,0,0,0,0,2,3,9,18,17,10,6,4,4,3,3,3,4,4,4,3,3,3,3,3,2,2,2,1,1,1,1,1,5,13,18,15,11,12,10,6,6,6,5,3,2,1,0,0,0,0,0,0,0,0,0,0,0,0,0,0,0,0,0,1,3,1,0,0,0,1,3,3,1,0,3,4,3,0,0,0,0,2,3,2,0,0
0,0,0,0,0,0,0,0,0,0,0,0,0,0,0,0,0,0,0,0,0,0,0,0,0,0,0,0,0,1,2,3,2,2,2,2,2,1,1,2,3,3,2,2,2,3,5,13,22,20,13,9,7,8,10,10,10,10,9,7,6,4,2,0,0,0,0,0,0,0,0,0,0,0,0,0,0,1,3,2,0,0,0,0,3,4,2,0,2,4,2,0,0,0,0,2,3,2,0,0
0,0,0,0,0,0,0,0,0,0,0,0,0,0,0,0,0,0,0,0,0,0,0,0,0,0,0,0,0,0,0,0,0,0,0,0,0,0,0,0,1,1,1,2,12,24,25,20,22,23,19,14,11,11,11,10,10,11,11,11,11,13,15,10,3,1,1,0,0,0,0,0,0,0,0,0,0,0,2,2,1,0,0,0,3,4,3,0,2,3,2,0,0,0,0,2,3,2,0,0
0,0,0,0,0,0,0,0,0,0,0,0,0,0,0,0,0,0,0,0,0,0,0,0,0,0,0,0,0,0,0,0,0,0,0,0,0,0,0,0,0,1,4,8,21,35,33,19,14,14,11,9,7,7,7,6,6,5,5,7,8,15,21,20,11,6,3,2,1,0,0,0,0,0,0,0,0,0,6,10,6,0,0,0,3,4,3,0,2,3,2,0,0,0,0,2,3,2,0,0
0,0,0,0,0,0,0,0,0,0,0,0,0,0,0,0,0,0,0,0,0,0,0,0,0,0,0,0,0,0,0,0,0,0,0,0,0,0,0,0,1,11,21,17,16,23,19,6,0,0,0,0,0,0,0,0,0,0,0,0,1,6,14,17,14,10,7,6,4,3,2,0,0,0,0,0,0,0,11,17,11,0,0,0,3,5,3,0,2,3,2,0,0,0,0,1,3,1,0,0
0,0,0,0,0,0,0,0,0,0,0,0,0,0,0,0,0,0,0,0,0,0,0,0,0,0,0,0,0,0,0,0,0,0,0,0,0,0,0,4,15,31,30,18,3,0,0,0,0,0,0,0,0,0,0,0,0,0,0,0,0,0,1,5,8,9,10,9,7,5,4,2,1,0,0,0,0,0,9,17,12,1,0,0,3,5,4,1,2,3,2,0,0,0,0,1,3,1,0,0
0,0,0,0,0,0,0,0,0,0,0,0,0,0,0,0,0,0,0,0,0,0,0,0,0,0,0,0,0,0,0,0,0,0,0,0,0,0,0,6,22,31,24,6,0,0,0,0,0,0,0,0,0,0,0,0,0,0,0,0,0,0,0,0,1,5,7,8,8,7,6,5,4,3,1,0,0,0,3,9,9,4,0,0,3,6,6,1,2,3,2,0,0,0,0,2,3,2,0,0
0,0,0,0,0,0,0,0,0,0,0,0,0,0,0,0,0,0,0,0,0,0,0,0,0,0,0,0,0,0,0,0,0,0,0,0,0,0,0,4,13,15,6,0,0,0,0,0,0,0,0,0,0,0,0,0,0,0,0,0,0,0,0,0,0,0,2,4,5,6,7,7,6,5,3,2,1,0,0,6,9,5,0,0,3,7,7,2,2,3,2,0,0,0,0,1,3,1,0,0
0,0,0,0,0,0,0,0,0,0,0,0,0,0,0,0,0,0,0,0,0,0,0,0,0,0,0,0,0,0,0,0,0,0,0,0,0,0,0,0,0,0,0,0,0,0,0,0,0,0,0,0,0,0,0,0,0,0,0,0,0,0,0,0,0,0,0,0,1,4,6,7,6,6,5,3,3,2,0,4,7,5,0,0,3,7,7,2,4,7,4,0,0,0,0,1,2,1,0,0
0,0,0,0,0,0,0,0,0,0,0,0,0,0,0,0,0,0,0,0,0,0,0,0,0,0,0,0,0,0,0,0,0,0,0,0,0,0,0,0,0,0,0,0,0,0,0,0,0,0,0,0,0,0,0,0,0,0,0,0,0,0,0,0,0,0,0,0,0,0,2,4,5,7,6,5,4,3,2,2,5,5,2,0,3,7,6,2,9,14,9,0,0,0,0,1,3,1,0,0
0,0,0,0,0,0,0,0,0,0,0,0,0,0,0,0,0,0,0,0,0,0,0,0,0,0,0,0,0,0,0,0,0,0,0,0,0,0,0,0,0,0,0,0,0,0,0,0,0,0,0,0,0,0,0,0,0,0,0,0,0,0,0,0,0,0,0,0,0,0,0,0,2,5,6,6,5,4,3,3,5,6,3,0,3,11,14,7,12,19,12,0,0,0,0,2,3,2,0,0
0,0,0,0,0,0,0,0,0,0,0,0,0,0,0,0,0,0,0,0,0,0,0,0,0,0,0,0,0,0,0,0,0,0,0,0,0,0,0,0,0,0,0,0,0,0,0,0,0,0,0,0,0,0,0,0,0,0,0,0,0,0,0,0,0,0,0,0,0,0,0,0,0,1,4,6,5,3,3,4,6,6,3,0,3,17,22,12,9,15,9,0,0,0,0,1,3,1,0,0
0,0,0,0,0,0,0,0,0,0,0,0,0,0,0,0,0,0,0,0,0,0,0,0,0,0,0,0,0,0,0,0,0,0,0,0,0,0,0,0,0,0,0,0,0,0,0,0,0,0,0,0,0,0,0,0,0,0,0,0,0,0,0,0,0,0,0,0,0,0,0,0,0,0,1,4,6,5,4,3,5,7,5,1,3,17,24,12,6,10,6,0,0,0,0,1,2,1,0,0
0,0,0,0,0,0,0,0,0,0,0,0,0,0,0,0,0,0,0,0,0,0,0,0,0,0,0,0,0,0,0,0,0,0,0,0,0,0,0,0,0,0,0,0,0,0,0,0,0,0,0,0,0,0,0,0,0,0,0,0,0,0,0,0,0,0,0,0,0,0,0,0,0,0,0,1,3,5,5,4,4,7,7,3,3,14,18,9,4,8,6,0,0,0,0,1,2,1,0,0
0,0,0,0,0,0,0,0,0,0,0,0,0,0,0,0,0,0,0,0,0,0,0,0,0,0,0,0,0,0,0,0,0,0,0,0,0,0,0,0,0,0,0,0,0,0,0,0,0,0,0,0,0,0,0,0,0,0,0,0,0,0,0,0,0,0,0,0,0,0,0,0,0,0,0,0,1,4,5,5,3,6,9,6,3,13,16,8,2,6,6,2,0,0,0,1,2,1,0,0
0,0,0,0,0,0,0,0,0,0,0,0,0,0,0,0,0,0,0,0,0,0,0,0,0,0,0,0,0,0,0,0,0,0,0,0,0,0,0,0,0,0,0,0,0,0,0,0,0,0,0,0,0,0,0,0,0,0,0,0,0,0,0,0,0,0,0,0,0,0,0,0,0,0,0,0,0,1,4,5,4,5,8,6,6,13,14,7,0,4,6,4,0,0,0,1,2,1,0,0
0,0,0,0,0,0,0,0,0,0,0,0,0,0,0,0,0,0,0,0,0,0,0,0,0,0,0,0,0,0,0,0,0,0,0,0,0,0,0,0,0,0,0,0,0,0,0,0,0,0,0,0,0,0,0,0,0,0,0,0,0,0,0,0,0,0,0,0,0,0,0,0,0,0,0,0,0,0,2,4,5,5,6,6,7,13,15,7,0,4,6,4,0,0,0,1,3,1,0,0
0,0,0,0,0,0,0,0,0,0,0,0,0,0,0,0,0,0,0,0,0,0,0,0,0,0,0,0,0,0,0,0,0,0,0,0,0,0,0,0,0,0,0,0,0,0,0,0,0,0,0,0,0,0,0,0,0,0,0,0,0,0,0,0,0,0,0,0,0,0,0,0,0,0,0,0,0,0,0,3,4,5,5,6,6,13,16,8,0,3,6,3,0,0,0,2,3,2,0,0
0,0,0,0,0,0,0,0,0,0,0,0,0,0,0,0,0,0,0,0,0,0,0,0,0,0,0,0,0,0,0,0,0,0,0,0,0,0,0,0,0,0,0,0,0,0,0,0,0,0,0,0,0,0,0,2,4,2,0,0,0,0,0,0,0,0,0,0,0,0,0,0,0,0,0,0,0,0,0,1,3,4,7,7,5,12,17,10,0,3,5,3,0,0,0,1,3,1,0,0
0,0,0,0,0,0,0,0,0,0,0,0,0,0,0,0,0,0,0,0,0,0,0,0,0,0,0,0,0,0,0,0,0,0,0,0,0,0,0,0,0,0,0,0,0,0,0,0,0,0,0,0,0,0,0,6,11,9,2,0,0,0,0,0,0,0,0,0,0,0,0,0,0,0,0,0,0,0,0,0,1,3,7,8,5,11,17,11,0,3,5,3,0,0,0,1,2,1,0,0
0,0,0,0,0,0,0,0,0,0,0,0,0,0,0,0,0,0,0,0,0,0,0,0,0,0,0,0,0,0,0,0,0,0,0,0,0,0,0,0,0,0,0,0,0,0,0,0,0,0,0,0,0,0,0,5,15,16,6,0,0,0,0,0,0,0,0,0,0,0,0,0,0,0,0,0,0,0,0,0,0,2,5,8,6,11,16,11,1,3,4,3,0,0,0,1,2,1,0,0
0,0,0,0,0,0,0,2,4,2,0,0,0,0,0,0,0,0,0,0,0,0,0,0,0,0,0,0,0,0,0,0,0,0,0,0,0,0,0,0,0,0,0,0,0,0,0,0,0,0,0,0,0,0,0,1,11,15,9,0,0,0,0,0,0,0,0,0,0,0,0,0,0,0,0,0,0,0,0,0,0,1,4,8,7,12,15,11,3,3,4,3,0,0,0,1,2,1,0,0
0,0,0,0,0,0,0,6,12,12,3,0,0,0,0,0,0,0,0,0,0,0,0,0,0,0,0,0,0,0,0,0,0,0,0,0,0,0,0,0,0,0,0,0,0,0,0,0,0,0,0,0,0,1,0,0,6,10,8,1,0,0,0,0,0,0,0,0,0,0,0,0,0,0,0,0,0,0,0,0,0,0,2,6,9,14,15,11,3,4,4,3,0,0,0,1,2,1,0,0
0,0,0,0,0,0,0,5,16,18,8,0,0,0,0,0,0,0,0,0,0,0,0,0,0,0,0,0,0,0,0,0,0,0,0,0,0,0,0,0,0,0,0,0,0,0,0,0,0,0,2,4,3,0,0,0,1,9,12,6,0,0,0,0,0,0,0,0,0,0,0,0,0,0,0,0,0,0,0,0,0,0,0,5,8,15,16,10,3,6,8,8,4,1,0,1,3,1,0,0
0,0,0,0,0,0,0,1,10,15,11,2,0,0,0,0,0,0,0,0,0,0,0,0,0,0,0,0,0,0,0,0,0,0,0,0,0,0,0,0,0,0,0,0,0,0,0,0,0,0,10,17,10,0,0,0,0,10,16,10,0,0,0,0,0,0,0,0,0,0,0,0,0,0,0,0,0,0,0,0,0,0,0,4,8,17,19,14,7,11,15,12,6,2,0,2,3,2,0,0
0,0,0,0,0,0,0,0,2,7,8,5,1,0,0,0,0,0,0,0,0,0,0,0,0,0,0,0,0,0,0,0,0,0,0,0,0,0,0,0,0,0,0,0,0,0,0,0,0,0,13,22,18,2,0,0,0,7,13,9,1,0,0,0,0,0,0,0,0,0,0,0,0,0,0,0,0,0,0,0,0,2,3,5,9,18,22,16,9,14,16,11,4,1,0,1,3,1,0,0
0,0,0,0,0,0,0,0,0,1,7,11,8,2,0,0,0,0,0,0,0,0,0,0,0,0,0,0,0,0,0,0,0,0,0,0,0,0,0,0,0,0,0,0,0,0,0,0,0,0,6,21,23,10,0,0,0,2,6,7,3,0,0,0,0,0,0,0,0,0,0,0,0,0,0,0,0,0,0,1,4,6,8,8,10,17,20,14,7,10,12,7,0,0,0,1,3,1,0,0
0,0,0,0,0,0,0,0,0,0,5,13,14,6,0,0,3,5,6,6,8,13,12,5,3,11,14,9,4,6,7,10,9,3,0,0,0,0,0,0,0,0,0,0,0,0,0,0,0,0,0,15,24,15,0,0,0,0,4,6,4,4,6,4,0,0,0,0,0,0,0,0,0,0,0,0,0,1,4,9,11,11,10,8,8,14,18,10,2,4,8,7,3,1,0,2,3,2,0,0
0,0,0,0,0,0,0,0,0,0,2,8,12,8,5,6,8,10,10,10,14,23,28,22,13,19,22,15,7,9,12,16,13,6,0,0,0,0,0,0,0,0,0,0,0,0,0,0,0,0,0,12,20,12,0,0,0,0,3,5,3,13,21,13,0,0,0,0,0,0,0,0,0,0,0,6,13,16,16,17,14,10,9,12,12,17,18,11,4,8,19,37,42,25,9,12,14,7,0,0
0,0,0,0,0,0,0,0,0,0,0,1,5,9,14,15,11,7,6,6,8,16,26,24,16,14,14,9,4,6,7,10,9,3,0,0,0,0,0,0,0,0,0,0,0,0,0,0,0,0,0,6,17,18,7,0,0,0,2,7,8,25,35,22,0,0,0,0,0,0,0,0,0,0,0,11,20,25,19,14,8,4,7,15,19,21,18,13,8,14,27,54,61,41,15,18,18,10,0,0
0,0,0,0,0,0,0,0,0,0,0,0,1,11,27,35,24,7,0,0,0,2,8,12,8,1,0,0,0,0,0,0,0,0,0,0,0,0,0,0,0,0,0,0,0,0,0,0,0,0,0,2,24,34,20,0,0,0,1,12,17,29,30,20,0,0,0,0,0,0,0,0,0,0,0,6,13,14,9,5,1,0,2,15,22,24,20,16,13,15,18,31,39,25,9,10,11,5,0,0
0,0,0,0,0,0,0,0,0,0,0,0,0,11,30,42,31,12,0,0,0,0,0,0,0,0,0,0,0,0,0,0,0,0,0,0,0,0,0,0,0,0,0,0,0,0,0,0,0,0,0,0,24,36,23,0,0,0,0,17,26,24,17,13,3,0,0,0,0,0,0,0,0,0,0,0,0,0,0,0,0,0,0,9,18,25,24,20,12,9,3,0,0,0,0,0,0,0,0,0
0,0,0,0,0,0,0,0,0,0,0,0,0,8,20,31,26,12,0,0,0,0,0,0,0,0,0,0,0,0,0,0,0,0,0,0,0,0,0,0,0,0,0,0,0,0,0,0,0,0,0,0,14,24,14,0,0,0,0,15,23,16,6,8,5,0,0,0,0,0,0,0,0,0,0,0,0,0,0,0,0,0,0,6,14,23,27,20,9,5,2,0,0,0,0,0,0,0,0,0
0,0,0,0,0,0,0,0,0,0,0,0,0,6,9,12,10,7,0,0,0,0,0,0,0,0,0,0,0,0,0,0,0,0,0,0,0,0,0,0,0,0,0,0,0,0,0,0,0,0,0,0,6,12,10,2,0,0,0,8,15,10,3,6,5,2,0,0,0,0,0,0,0,0,0,0,0,0,0,0,0,0,0,3,7,19,25,18,5,3,2,0,0,0,0,0,0,0,0,0
0,0,0,0,0,0,0,0,0,0,0,0,0,4,7,9,8,6,2,0,0,0,0,0,0,0,0,0,0,0,0,0,0,0,0,0,0,0,0,0,0,0,0,0,0,0,0,0,0,0,0,0,2,8,9,5,0,0,0,2,7,7,3,3,8,10,4,0,0,0,0,0,0,0,0,0,0,0,0,0,0,0,0,0,2,15,24,16,3,2,2,1,0,0,0,0,0,0,0,0
0,0,0,0,0,0,0,0,0,0,0,0,0,1,6,7,7,6,5,2,0,0,0,0,0,0,0,0,0,0,0,0,0,0,0,0,0,0,0,0,0,0,0,0,0,0,0,0,0,0,0,0,0,4,8,7,1,0,0,0,4,6,4,1,17,25,15,0,0,0,0,0,0,0,0,0,0,0,0,0,0,0,0,0,3,16,23,14,2,0,1,1,1,0,0,0,0,0,0,0
0,0,0,0,0,0,0,0,0,0,0,0,0,0,4,7,7,5,5,4,2,0,0,0,0,0,0,0,0,0,0,0,0,0,0,0,0,0,0,0,0,0,0,0,0,0,0,0,0,0,0,0,0,1,5,6,4,0,0,0,3,6,3,0,18,29,22,2,0,0,0,0,0,0,0,0,0,0,0,0,0,0,0,0,4,16,22,13,3,1,0,2,2,1,0,0,0,0,0,0
0,0,0,0,0,0,0,0,0,0,0,0,0,0,1,5,6,4,4,5,4,1,0,0,0,0,0,0,0,0,0,0,0,0,0,0,0,0,0,0,0,0,0,0,0,0,0,0,0,0,0,0,0,0,2,6,6,2,0,0,2,5,4,0,7,19,17,7,0,0,0,0,0,0,0,0,0,0,0,0,0,0,0,0,3,14,21,16,5,1,0,2,3,2,0,0,0,0,0,0
0,0,0,0,0,0,0,0,0,0,0,0,0,0,0,2,5,5,3,3,4,3,1,0,0,0,0,0,0,0,0,0,0,0,0,0,0,0,0,0,0,0,0,0,0,0,0,0,0,0,0,0,0,0,0,4,6,4,0,0,1,4,4,2,0,5,10,8,1,0,0,0,0,1,2,1,0,0,0,0,0,0,0,0,0,12,22,19,7,1,0,1,3,3,1,0,0,0,0,0
0,0,0,0,0,0,0,0,0,0,0,0,0,0,0,0,2,5,5,3,3,3,3,2,0,0,0,0,0,0,0,0,0,0,0,0,0,0,0,0,0,0,0,0,0,0,0,0,0,0,0,0,0,0,0,1,5,5,2,0,0,2,4,2,0,1,6,6,3,0,0,0,1,4,4,4,3,2,0,0,0,0,0,0,0,9,21,21,11,3,0,0,2,3,1,0,0,0,0,0
0,0,0,0,0,0,0,0,0,0,0,0,0,0,0,0,0,3,6,5,3,2,3,3,2,1,0,0,0,0,0,0,0,0,0,0,0,0,0,0,0,0,0,0,0,0,0,0,0,0,0,0,0,0,0,0,2,4,5,2,0,2,5,4,1,0,3,4,3,0,0,1,2,4,4,5,6,6,4,1,0,0,0,0,0,7,17,20,12,6,2,1,1,3,2,0,0,0,0,0
0,0,0,0,0,0,0,0,0,0,0,0,0,0,0,0,0,1,3,5,4,2,2,2,3,3,3,1,0,0,0,0,0,0,0,0,0,0,0,0,0,0,0,0,0,0,0,0,0,0,0,0,0,0,0,0,0,3,5,4,3,7,13,16,13,6,2,5,9,11,9,5,3,1,1,2,5,6,6,5,2,0,0,0,0,6,13,16,12,8,5,4,2,2,3,1,0,0,0,0
0,0,0,0,0,0,0,0,0,0,0,0,0,0,0,0,0,0,0,2,4,4,3,1,1,3,3,3,2,1,1,0,0,0,0,0,0,0,0,0,0,0,0,0,0,0,0,0,0,0,0,0,0,0,0,0,0,0,6,12,15,16,19,25,22,16,9,14,20,21,20,15,11,7,4,1,2,5,7,7,6,3,0,0,0,5,10,13,12,9,6,5,3,3,3,3,2,1,0,0
0,0,0,0,0,0,0,0,0,0,0,0,0,0,0,0,0,0,0,0,2,4,4,3,1,0,1,2,3,3,2,2,3,4,2,0,0,0,0,0,0,0,0,0,0,0,0,0,0,0,0,0,0,0,0,0,2,3,9,19,22,19,16,20,25,23,19,21,22,22,21,20,15,12,9,7,6,5,6,7,7,5,3,0,0,6,10,12,12,11,5,4,5,5,3,5,5,3,0,0
0,0,0,0,0,0,0,0,0,0,0,0,0,0,0,0,0,0,0,0,0,1,3,4,3,1,0,0,1,1,2,3,7,10,10,6,4,2,0,0,0,0,0,0,0,0,0,0,0,0,0,0,0,0,2,5,6,6,9,16,17,10,7,11,19,22,22,19,16,15,14,13,9,8,8,8,8,7,6,6,6,6,5,2,0,6,10,11,12,12,5,2,5,7,7,9,9,5,0,0
0,0,0,0,0,0,0,0,0,0,0,0,0,0,0,0,0,0,0,0,0,0,1,3,4,3,2,1,0,0,0,1,6,11,12,9,7,4,3,3,3,2,0,0,0,0,0,0,0,0,0,0,2,4,5,7,6,4,4,4,4,2,3,11,15,18,18,17,15,17,15,9,4,4,6,7,8,8,8,7,7,8,10,7,2,6,10,11,12,12,6,1,3,9,13,14,12,6,0,0
0,0,0,0,0,0,0,0,0,0,0,0,0,0,0,0,0,0,0,0,0,0,0,0,2,3,7,14,18,13,7,4,3,4,6,6,4,4,4,4,4,4,3,2,2,1,0,0,0,0,1,3,5,5,5,4,2,0,1,6,10,9,10,14,13,15,22,25,21,21,21,16,12,10,9,10,12,15,15,14,11,11,13,12,8,9,9,12,11,10,4,3,2,7,11,18,16,8,0,0
0,0,0,0,0,0,0,0,0,0,0,0,0,0,0,0,0,0,0,0,0,0,0,0,0,1,7,20,28,24,14,9,6,4,3,3,3,2,2,3,3,3,3,3,3,2,2,2,2,4,6,6,8,8,7,6,5,5,8,24,34,29,20,18,12,21,43,51,38,23,19,18,20,21,19,14,13,14,16,16,18,19,18,17,14,15,12,13,11,8,3,3,1,2,7,15,15,8,0,0
0,0,0,0,0,0,0,0,0,0,0,0,0,0,0,0,0,0,0,0,0,0,0,0,0,0,3,11,18,16,11,10,10,9,7,6,5,3,3,3,3,3,3,3,2,2,3,5,8,9,11,12,11,10,9,8,8,8,13,31,39,33,21,18,17,37,68,72,44,18,10,10,17,21,18,10,7,6,7,10,17,24,23,19,18,21,18,17,14,10,5,7,6,2,4,10,10,3,0,0
0,0,0,0,0,0,0,0,0,0,0,0,0,0,0,0,0,0,0,0,0,0,0,0,0,0,0,0,0,1,2,5,7,8,7,7,7,6,5,5,4,4,3,3,4,6,9,16,22,22,16,13,10,8,7,7,6,6,9,17,20,14,13,15,21,44,68,61,30,6,1,2,7,10,8,2,0,0,0,1,8,17,20,18,20,29,28,24,17,12,6,9,10,7,7,8,5,0,0,0
0,0,0,0,0,0,0,0,0,0,0,0,0,0,0,0,0,0,0,0,0,0,0,0,0,0,0,0,0,0,0,1,2,3,3,5,6,7,7,7,7,6,6,7,9,10,11,20,26,23,12,8,4,2,2,2,2,2,3,3,2,2,9,13,25,38,46,28,10,0,0,0,0,0,0,0,0,0,0,0,1,4,10,14,21,32,35,27,17,10,4,6,8,9,10,8,4,0,0,0
0,0,0,0,0,0,0,0,0,0,0,0,0,0,0,0,0,0,0,0,0,0,0,0,0,0,0,0,0,0,0,0,0,0,1,3,3,4,4,5,6,6,6,7,8,8,7,10,14,12,5,1,0,0,1,1,1,1,1,2,2,3,7,10,18,24,25,15,6,0,0,0,0,0,0,0,0,0,0,0,0,0,6,13,17,27,31,29,18,9,0,1,7,14,14,7,1,0,0,0
0,0,0,0,0,0,0,0,0,0,0,0,0,0,0,0,0,0,0,0,0,0,0,0,0,0,0,0,0,0,0,0,0,0,0,0,0,0,2,3,4,4,3,4,3,1,0,0,0,0,0,0,0,0,0,0,0,0,0,1,1,1,4,5,9,12,29,37,20,0,0,0,0,0,0,0,0,0,0,0,0,0,6,11,11,19,28,32,23,13,4,8,16,23,21,10,2,0,0,0
0,0,0,0,0,0,0,0,0,0,0,0,0,0,0,0,0,0,0,0,0,0,0,0,0,0,0,0,0,0,0,0,0,0,0,0,0,0,0,0,0,0,0,0,0,0,0,0,0,0,0,0,0,0,0,0,0,0,0,0,0,0,0,1,1,1,31,44,30,0,0,0,0,0,0,0,0,0,0,0,0,2,6,9,8,15,26,33,28,19,13,14,20,24,23,16,7,2,0,0
0,0,0,0,0,0,0,0,0,0,0,0,0,0,0,0,0,0,0,0,0,0,0,0,0,0,0,0,0,0,0,0,0,0,0,0,0,0,0,0,0,0,0,0,0,0,0,0,0,0,0,0,0,0,0,0,0,0,0,0,0,0,0,0,0,0,15,27,15,0,0,0,0,0,0,0,0,0,0,0,0,4,5,8,9,15,22,28,28,25,21,19,17,16,16,17,11,4,0,0
0,0,0,0,0,0,0,0,0,0,0,0,0,0,0,0,0,0,0,0,0,0,0,0,0,0,0,0,0,0,0,0,0,0,0,0,0,0,0,0,0,0,0,0,0,0,0,0,0,0,0,0,0,0,0,0,0,0,0,0,0,0,0,0,0,0,0,0,0,0,0,0,0,0,0,0,0,0,0,0,1,5,6,9,11,16,20,23,22,24,24,19,14,8,9,13,10,4,0,0
0,0,0,0,0,0,0,0,0,0,0,0,0,0,0,0,0,0,0,0,0,0,0,0,0,0,0,0,0,0,0,0,0,0,0,0,0,0,0,0,0,0,0,0,0,0,0,0,0,0,0,0,0,0,0,0,0,0,0,0,0,0,0,0,0,0,0,0,0,0,0,0,0,0,0,0,0,0,0,0,3,6,7,8,13,19,22,20,16,18,19,17,11,7,6,10,8,3,0,0
0,0,0,0,0,0,0,0,0,0,0,0,0,0,0,0,0,0,0,0,0,0,0,0,0,0,0,0,0,0,0,0,0,0,0,0,0,0,0,0,0,0,0,0,0,0,0,0,0,0,0,0,0,0,0,0,0,0,0,0,0,0,0,0,0,0,0,0,0,0,0,0,0,0,0,0,0,0,0,0,3,7,8,9,13,20,23,17,14,16,14,9,5,4,4,10,12,6,0,0
0,0,0,0,0,0,0,0,0,0,0,0,0,0,0,0,0,0,0,0,0,0,0,0,0,0,0,0,0,0,0,0,0,0,0,0,0,0,0,0,0,0,0,0,0,0,0,0,0,0,0,0,0,0,0,0,0,0,0,0,0,0,0,0,0,0,0,0,0,0,0,0,0,0,0,0,0,0,0,0,4,9,10,9,12,18,21,20,33,54,55,39,25,15,14,35,41,21,0,0
0,0,0,0,0,0,0,0,0,0,0,0,0,0,0,0,0,0,0,0,0,0,0,0,0,0,0,0,0,0,0,0,0,0,0,0,0,0,0,0,0,0,0,0,0,0,0,0,0,0,0,0,0,0,0,0,0,0,0,0,0,0,0,0,0,0,0,0,0,0,0,0,0,0,0,0,0,0,0,0,5,11,12,8,9,19,34,48,67,81,77,56,36,23,22,47,50,28,0,0
0,0,0,0,0,0,0,0,0,0,0,0,0,0,0,0,0,0,0,0,0,0,0,0,0,0,0,0,0,0,0,0,0,0,0,0,0,0,0,0,0,0,0,0,0,0,0,0,0,0,0,0,0,0,0,0,0,0,0,0,0,0,0,0,0,0,0,0,0,0,0,0,0,0,0,0,0,0,0,0,6,12,12,7,10,27,48,64,64,60,46,34,21,13,13,26,30,14,0,0
0,0,0,0,0,0,0,0,0,0,0,0,0,0,0,0,0,0,0,0,0,0,0,0,0,0,0,0,0,0,0,0,0,0,0,0,0,0,0,0,0,0,0,0,0,0,0,0,0,0,0,0,0,0,0,0,0,0,0,0,0,0,0,0,0,0,0,0,0,0,0,0,0,0,0,0,0,0,0,0,5,10,10,6,12,29,43,44,29,11,0,0,0,0,0,0,0,0,0,0
0,0,0,0,0,0,0,0,0,0,0,0,0,0,0,0,0,0,0,0,0,0,0,0,0,0,0,0,0,0,0,0,0,0,0,0,0,0,0,0,0,0,0,0,0,0,0,0,0,0,0,0,0,0,0,0,0,0,0,0,0,0,0,0,0,0,0,0,0,0,0,0,0,0,0,0,0,0,0,0,3,6,5,4,8,19,20,11,1,0,0,0,0,0,0,0,0,0,0,0
