0,0,0,0,0,0,0,0,0,0,0,0,0,0,0,0,0,0,0,0,0,0,0,0,0,0,0,0,0,0,0,0,0,0,0,0,0,0,0,0,0,0,0,0,0,0,0,0,0,0,0,0,0,0,0,0,0,0,0,0,0,0,0,0,0,0,0,0,0,0,0,0,0,0,0,0,0,0,0,0,0,0,0,0,0,0,0,0,0,0,0,0,0,0,0,0,0,0,0,0
0,0,0,0,0,0,0,0,0,0,0,0,0,0,0,0,0,0,0,0,0,0,0,0,0,0,0,0,0,0,0,0,0,0,0,0,0,0,0,0,0,0,0,0,0,0,0,0,0,0,0,0,0,0,0,0,0,0,0,0,0,0,0,0,0,0,0,0,0,0,0,0,0,0,0,0,0,0,0,0,0,0,0,0,0,0,0,0,0,0,0,0,0,0,0,0,0,0,0,0
0,0,0,0,0,0,0,0,0,0,0,0,0,0,0,0,0,0,0,0,0,0,0,0,0,0,0,0,0,0,0,0,0,0,0,0,0,0,0,0,0,0,0,0,0,0,0,0,0,0,0,0,0,0,0,0,0,0,0,0,0,0,0,0,0,0,0,0,0,0,0,0,0,0,0,0,0,0,0,0,0,0,0,0,0,0,0,0,0,0,0,0,0,0,0,0,0,0,0,0
0,0,0,0,0,0,0,0,0,0,0,0,0,0,0,0,0,0,0,0,0,0,0,0,0,0,0,0,0,0,0,0,0,0,0,0,0,0,0,0,0,0,0,0,0,0,0,0,0,0,0,0,0,0,0,0,0,0,0,0,0,0,0,0,0,0,0,0,0,0,0,0,0,0,0,0,0,0,0,0,0,0,0,0,0,0,0,0,0,0,0,0,0,0,0,0,0,0,0,0
0,0,0,0,0,0,0,0,0,0,2,10,12,6,0,0,0,0,0,0,0,0,0,0,0,0,0,0,0,0,0,0,0,0,0,0,0,0,0,0,0,0,0,0,0,0,0,0,0,0,0,0,0,0,0,0,0,0,0,0,0,0,0,0,0,0,0,0,0,0,0,0,0,0,0,0,1,2,2,0,0,0,0,0,0,0,0,0,0,0,0,0,0,0,0,0,0,0,0,0
0,0,0,0,0,0,0,0,0,0,4,18,25,20,12,15,17,13,5,0,0,0,0,0,0,0,0,0,0,0,0,0,0,0,0,0,0,0,0,0,0,0,0,0,0,0,0,0,0,0,0,0,0,0,0,0,0,0,0,0,0,0,0,0,0,0,0,0,0,0,0,0,0,0,0,1,3,5,7,6,3,1,0,0,0,0,0,0,0,0,0,0,0,0,0,0,0,0,0,0
0,0,0,0,0,0,0,0,0,0,2,12,22,21,20,24,32,32,23,10,7,6,4,2,0,0,0,0,0,0,0,0,0,0,0,0,0,0,0,0,0,0,0,0,0,0,0,0,0,0,0,0,0,0,0,0,0,0,0,0,0,0,0,0,0,0,0,0,0,0,0,0,0,0,1,2,3,5,7,9,8,5,1,0,0,0,0,0,0,0,0,0,0,0,0,0,0,0,0,0
0,0,0,0,0,0,0,0,0,0,0,1,6,9,12,15,25,31,28,17,12,9,8,6,12,19,15,6,2,0,0,0,0,0,0,0,0,0,0,0,0,0,0,0,0,0,0,0,0,0,0,0,0,0,0,0,0,0,0,0,0,0,0,0,0,0,0,0,0,0,0,0,0,0,2,2,1,1,3,6,8,8,5,1,0,0,0,0,0,0,0,0,0,0,0,0,0,0,0,0
0,0,0,0,0,0,0,0,0,0,0,0,0,0,0,0,4,12,14,10,7,6,5,6,20,28,25,12,8,5,4,2,0,0,0,0,0,0,0,0,0,0,0,0,0,4,14,19,12,4,0,0,0,0,0,0,0,0,0,0,0,0,0,0,0,0,0,0,0,0,0,0,0,2,2,2,0,0,0,0,3,7,7,4,0,0,0,0,0,0,0,0,0,0,0,0,0,0,0,0
0,0,0,0,0,0,0,0,0,0,0,0,0,0,0,0,0,0,0,0,0,0,0,2,11,19,15,10,9,8,8,6,5,3,2,1,0,0,0,0,0,0,0,0,0,7,22,29,21,14,18,22,16,6,0,0,0,0,0,0,0,0,0,0,0,0,0,0,0,0,0,0,2,3,2,0,0,0,0,0,0,3,7,7,3,0,0,0,0,0,0,0,0,0,0,0,0,0,0,0
0,0,0,0,0,0,0,0,0,0,0,0,0,0,0,0,0,0,0,0,0,0,0,0,0,0,0,2,4,5,5,6,6,6,5,4,3,3,1,0,0,0,0,0,0,4,14,19,14,17,27,36,31,20,8,6,6,4,2,0,0,0,0,0,0,0,0,0,0,0,0,2,5,5,1,0,0,0,0,0,0,0,5,7,5,1,0,0,0,0,0,0,0,0,0,0,0,0,0,0
0,0,0,0,0,0,0,0,0,0,0,0,0,0,0,0,0,0,0,0,0,0,0,0,0,0,0,0,0,0,0,2,3,3,4,5,5,5,3,3,3,2,1,0,0,0,0,0,1,7,16,24,26,21,14,10,9,8,6,8,14,13,5,0,0,1,2,3,3,3,4,6,7,9,8,5,0,0,0,0,0,0,1,6,7,3,0,0,0,0,0,0,0,0,0,0,0,0,0,0
0,0,0,0,0,0,0,0,0,0,0,0,0,0,0,0,0,0,0,0,0,0,0,0,0,0,0,0,0,0,0,0,0,0,0,2,3,3,3,4,4,4,4,3,3,3,2,0,0,0,0,1,6,9,9,8,9,9,9,15,28,32,21,7,5,6,9,10,10,11,13,12,10,16,19,15,6,6,5,5,4,2,0,4,7,5,0,0,0,0,0,0,0,0,0,0,0,0,0,0
0,0,0,0,0,0,0,0,0,0,0,0,0,0,0,0,0,0,0,0,0,0,0,0,0,0,0,0,0,0,0,0,0,0,0,0,0,0,1,2,3,4,4,5,4,4,4,3,3,3,3,3,3,3,3,4,4,5,7,12,25,32,26,15,12,12,13,13,13,14,14,12,10,16,23,21,14,12,10,11,12,9,3,2,5,5,1,0,0,0,0,0,0,0,0,0,0,0,0,0
0,0,0,0,0,0,0,0,0,0,0,0,0,0,0,0,0,0,0,0,0,0,0,0,0,0,0,0,0,0,0,0,0,0,0,0,0,0,0,0,0,0,2,3,3,3,3,4,4,4,4,4,4,4,4,3,3,3,3,3,6,12,15,15,14,12,10,8,8,7,7,5,5,8,15,17,14,10,9,9,13,14,11,4,5,6,3,0,0,0,0,0,0,0,0,0,0,0,0,0
0,0,0,0,0,0,0,0,0,0,0,0,0,0,0,0,0,0,0,0,0,0,0,0,0,0,0,0,0,0,0,0,0,0,0,0,0,0,0,0,0,0,0,0,0,0,0,2,3,3,3,3,3,3,2,0,0,1,2,3,3,3,4,7,8,6,3,2,1,1,0,0,0,1,7,11,8,2,2,2,5,12,13,9,8,8,4,0,0,0,0,0,0,0,0,0,0,0,0,0
0,0,0,0,0,0,0,0,0,0,0,0,0,0,0,0,0,0,0,0,0,0,0,0,0,0,0,0,0,0,0,0,0,0,0,0,0,0,0,0,0,0,0,0,0,0,0,0,0,0,0,0,0,1,3,4,4,4,5,5,4,4,3,3,2,1,0,0,0,0,0,0,0,0,5,8,5,0,0,0,0,4,10,11,10,10,7,1,0,0,0,0,0,0,0,0,0,0,0,0
0,0,0,0,0,0,0,0,0,0,0,0,0,0,0,0,0,0,0,0,0,0,0,0,0,0,0,0,0,0,0,0,0,0,0,0,0,0,0,0,0,0,0,0,0,0,2,6,10,9,9,13,14,11,9,7,6,5,4,3,3,2,1,0,0,0,0,0,0,0,0,0,0,0,4,7,4,0,0,0,0,0,6,9,9,8,8,5,2,0,0,0,0,0,0,0,0,0,0,0
0,0,0,0,0,0,0,0,0,0,0,0,0,0,0,0,0,0,0,0,0,0,0,0,0,0,0,0,0,0,0,0,0,0,0,0,0,0,0,0,2,5,6,4,4,4,4,11,15,15,15,21,23,16,9,5,4,2,0,0,0,0,0,0,0,0,0,0,0,0,0,0,0,0,3,6,3,0,0,0,0,0,3,7,6,6,7,6,4,2,0,0,0,0,0,0,0,0,0,0
0,0,0,0,0,0,0,0,0,0,0,0,0,0,0,0,0,0,0,0,0,0,0,0,0,0,0,0,0,0,0,0,0,0,0,0,0,0,3,7,12,14,12,7,7,5,4,6,10,9,9,13,14,9,3,0,0,0,0,0,0,0,0,0,0,0,0,0,0,0,0,0,0,0,3,5,3,0,0,0,0,0,1,5,6,6,5,5,3,3,1,0,0,0,0,0,0,0,0,0
0,0,0,0,0,0,0,0,0,0,0,0,0,0,0,0,0,0,0,0,0,0,0,0,0,0,0,0,0,0,0,0,0,0,0,0,0,0,5,11,17,15,10,4,4,3,1,0,0,0,0,0,0,0,0,0,0,0,0,0,0,0,0,0,0,0,0,0,0,0,0,0,0,0,3,5,3,0,0,0,0,0,0,4,7,8,5,4,7,12,8,1,0,0,0,0,0,0,0,0
0,0,0,0,0,0,0,0,0,0,0,0,0,0,0,0,0,0,0,0,0,0,0,0,0,0,0,0,0,0,0,0,0,0,0,0,0,0,3,7,9,6,2,0,0,0,0,0,0,0,0,0,0,0,0,0,0,0,0,0,0,0,0,0,0,0,0,0,0,0,0,0,0,0,3,4,3,0,0,0,0,0,0,4,6,7,5,3,11,19,15,3,0,0,0,0,0,0,0,0
0,0,0,0,0,0,0,0,0,0,0,0,0,0,0,0,0,0,0,0,0,0,0,0,0,0,0,0,0,0,0,0,0,0,0,0,0,0,0,0,0,0,0,0,0,0,0,0,0,0,0,0,0,0,0,0,0,0,0,0,0,0,0,0,0,0,0,0,0,0,0,0,0,0,2,4,3,0,0,0,0,0,0,2,5,7,6,3,11,19,14,3,2,0,0,0,0,0,0,0
0,0,0,0,0,0,0,0,0,0,0,0,0,0,0,0,0,0,0,0,0,0,0,0,0,0,0,0,0,0,0,0,0,0,0,0,0,0,0,0,0,0,0,0,0,0,0,0,0,0,0,0,0,0,0,0,0,0,0,0,0,0,0,0,0,0,0,0,0,0,0,0,0,0,1,3,3,1,0,0,0,0,0,0,4,8,7,3,7,11,8,3,3,1,0,0,0,0,0,0
0,0,0,0,0,0,0,0,0,0,0,0,0,0,0,0,0,0,0,0,0,0,0,0,0,0,0,0,0,0,0,0,0,0,0,0,0,0,0,0,0,0,0,0,0,0,0,0,0,0,0,0,0,0,0,0,0,0,0,0,0,0,0,0,0,0,0,0,0,0,0,0,0,0,0,3,4,2,0,0,0,0,0,0,3,8,8,3,5,9,6,2,3,2,0,0,0,0,0,0
0,0,0,0,0,0,0,0,0,0,0,0,0,0,0,0,0,0,0,0,0,0,0,0,0,0,0,0,0,0,0,0,0,0,0,0,0,0,0,0,0,0,0,0,0,0,0,0,0,0,0,0,0,0,0,0,0,0,0,0,0,0,0,0,0,0,0,0,0,0,0,0,0,0,0,3,4,3,0,0,0,0,0,0,3,7,7,3,5,8,5,0,2,3,1,0,0,0,0,0
0,0,0,0,0,0,0,0,0,0,0,0,0,0,0,0,0,0,0,0,0,0,0,0,0,0,0,0,0,0,0,0,0,0,0,0,0,0,0,0,0,0,0,0,0,0,0,0,0,0,0,0,0,0,0,0,0,0,0,0,0,0,0,0,0,0,0,0,0,0,0,0,0,0,0,3,4,3,0,0,0,0,0,0,3,7,7,3,4,7,4,0,1,3,2,0,0,0,0,0
0,0,0,0,0,0,0,0,0,0,0,0,0,0,0,0,0,0,0,0,0,0,0,0,0,0,0,0,0,0,0,0,0,0,0,0,0,0,0,0,0,0,0,0,0,0,0,0,0,0,0,0,0,0,0,0,0,0,0,0,0,0,0,0,0,0,0,0,0,0,0,0,0,0,0,2,4,2,0,0,0,0,0,0,3,7,7,3,4,6,4,0,0,2,3,1,0,0,0,0
0,0,0,0,0,0,0,0,0,0,0,0,0,0,0,0,0,0,0,0,0,0,0,0,0,0,0,0,0,0,0,0,0,0,0,0,0,0,0,0,0,0,0,0,0,0,0,0,0,0,0,0,0,0,0,0,0,0,0,0,0,0,0,0,0,0,0,0,0,0,0,0,0,0,0,2,3,2,0,0,0,0,0,0,3,7,7,3,3,6,3,0,0,2,3,2,0,0,0,0
0,0,0,0,0,0,0,0,0,0,0,0,0,0,0,0,0,0,0,0,0,0,0,0,0,0,0,0,0,0,0,0,0,0,0,0,0,0,0,0,0,0,0,0,0,0,0,0,0,0,0,0,0,0,0,0,0,0,0,0,0,0,0,0,0,0,0,0,0,0,0,0,0,0,0,2,3,2,0,0,0,0,0,0,3,7,7,3,4,5,2,0,0,1,3,2,0,0,0,0
0,0,0,0,0,0,0,0,0,0,0,0,0,0,0,0,0,0,0,0,0,0,0,0,0,0,0,0,0,0,0,0,0,0,0,0,0,0,0,0,0,0,0,0,0,0,0,0,0,0,0,0,0,0,0,0,0,0,0,0,0,0,0,0,0,0,0,0,0,0,0,0,0,0,0,2,3,2,0,0,0,0,0,0,3,7,7,4,4,4,1,0,0,1,2,2,1,0,0,0
0,0,0,0,0,0,0,0,0,0,0,0,0,0,0,0,0,0,0,0,0,0,0,0,0,0,0,0,0,0,0,0,0,0,0,0,0,0,0,0,0,0,0,0,0,0,0,0,0,0,0,0,0,0,0,0,0,0,0,0,0,0,0,0,0,0,0,0,0,0,0,0,0,0,0,2,3,2,0,0,0,0,0,0,2,6,6,5,4,3,0,0,0,0,2,3,1,0,0,0
0,0,0,0,0,0,0,0,0,0,0,0,0,0,0,0,0,0,0,0,0,0,0,0,0,0,0,0,0,0,0,0,0,0,0,0,0,0,0,0,0,0,0,0,0,0,0,0,0,0,0,0,0,0,0,0,0,0,0,0,0,0,0,0,0,0,0,0,0,0,0,0,0,0,0,1,3,2,0,0,0,0,0,0,2,6,6,5,4,3,0,0,0,0,2,3,2,0,0,0
0,0,0,0,0,0,0,0,0,0,1,5,11,11,5,0,0,0,0,0,0,0,0,0,0,0,0,0,0,0,0,0,0,0,0,0,0,0,0,0,0,0,0,0,0,0,0,0,0,0,0,0,0,0,0,0,0,0,0,0,0,0,0,0,0,0,0,0,0,0,0,0,0,0,0,1,2,2,1,0,0,0,0,0,1,6,7,6,4,3,0,0,0,0,1,3,1,0,0,0
0,0,0,0,0,0,0,0,0,0,2,8,18,19,14,5,2,0,0,0,0,0,0,0,0,0,0,0,0,0,0,0,0,0,0,0,0,0,0,0,0,0,0,0,0,0,0,0,0,0,0,0,0,0,0,0,0,0,0,0,0,0,0,0,0,0,0,0,0,0,0,0,0,0,0,0,2,3,1,0,0,0,0,0,0,6,8,7,4,3,0,0,0,0,1,2,1,0,0,0
0,0,0,0,0,0,0,0,0,0,1,5,11,15,12,9,6,4,6,8,6,1,0,0,0,0,0,0,0,0,0,0,0,0,0,0,0,0,0,0,0,0,0,0,0,2,4,3,0,0,0,0,0,0,0,0,0,0,0,0,0,0,0,0,0,0,0,0,0,0,0,0,0,0,0,0,2,3,2,0,0,0,0,0,0,5,8,8,4,3,0,0,0,0,1,2,2,0,0,0
0,0,0,0,0,0,0,0,0,0,0,0,0,2,4,6,6,6,9,19,26,22,11,6,4,4,3,3,3,3,3,2,2,2,2,2,1,8,15,11,3,0,0,0,0,4,9,10,6,5,4,3,3,6,9,6,1,0,0,0,0,0,0,0,0,0,0,0,0,0,0,0,0,0,0,0,1,3,1,0,0,0,0,0,0,5,8,8,4,2,0,0,0,0,1,2,2,1,0,0
0,0,0,0,0,0,0,0,0,0,0,0,0,0,0,0,2,3,6,19,32,32,19,10,7,6,5,4,4,4,4,4,3,3,3,3,3,14,22,20,8,5,4,3,3,6,16,20,14,8,7,5,4,11,15,13,6,3,1,0,0,0,0,0,0,0,0,0,0,0,0,0,0,0,0,0,1,2,1,0,0,0,0,0,0,6,9,8,3,2,0,0,0,0,0,2,2,1,0,0
0,0,0,0,0,0,0,0,0,0,0,0,0,0,0,0,0,0,0,6,17,19,11,6,4,4,3,3,3,3,3,2,2,2,2,2,1,8,15,13,8,7,6,5,4,5,15,21,17,8,7,7,7,11,14,13,11,9,7,5,4,3,2,1,0,0,0,0,0,0,0,0,0,0,0,0,1,3,1,0,0,0,0,0,0,5,8,8,4,2,0,0,0,0,0,1,2,1,0,0
0,0,0,0,0,0,0,0,0,0,0,0,0,0,0,0,0,0,0,0,0,0,0,0,0,0,0,0,0,0,0,0,0,0,0,0,0,0,0,1,3,4,4,3,3,3,8,13,11,8,8,8,8,8,8,10,11,11,10,9,12,14,10,4,2,2,2,1,0,0,0,0,0,0,0,0,2,3,2,0,0,0,0,0,0,5,8,7,4,2,0,0,0,0,0,1,2,1,0,0
0,0,0,0,0,0,0,0,0,0,0,0,0,0,0,0,0,0,0,0,0,0,0,0,0,0,0,0,0,0,0,0,0,0,0,0,0,0,0,0,0,0,0,0,0,0,4,9,10,10,9,7,6,6,6,6,6,6,6,8,15,19,17,8,5,3,3,3,2,1,0,0,0,0,0,0,1,3,1,0,0,0,0,0,0,5,9,8,3,1,0,0,0,0,0,1,2,1,0,0
0,0,0,0,0,0,0,0,0,0,0,0,0,0,0,0,0,0,0,0,0,0,0,0,0,0,0,0,0,0,0,0,0,0,0,0,0,0,0,0,0,0,0,0,6,18,22,15,9,6,4,2,1,1,1,2,1,1,1,3,8,14,13,11,8,4,3,3,3,3,2,2,0,0,0,0,1,7,10,5,0,0,0,0,0,6,10,8,2,1,0,0,0,0,0,1,2,1,0,0
0,0,0,0,0,0,0,0,0,0,0,0,0,0,0,0,0,0,0,0,0,0,0,0,0,0,0,0,0,0,0,0,0,0,0,0,0,0,0,4,12,11,6,10,25,33,28,15,4,1,0,0,0,0,0,0,0,0,0,1,2,3,5,8,8,7,5,4,3,2,3,4,3,1,0,0,0,12,18,12,0,0,0,0,0,5,10,9,2,0,0,0,0,0,0,1,3,1,0,0
0,0,0,0,0,0,0,0,0,0,0,0,0,0,0,0,0,0,0,0,0,0,0,0,0,0,0,0,0,0,0,0,0,0,0,0,0,0,0,8,21,26,18,20,27,28,16,5,0,0,0,0,0,0,0,0,0,0,0,0,0,0,0,3,6,8,8,7,5,3,3,4,3,3,2,1,0,11,18,11,0,0,0,0,0,5,10,8,2,0,0,0,0,0,0,2,3,2,0,0
0,0,0,0,0,0,0,0,0,0,0,0,0,0,0,0,0,0,0,0,0,0,0,0,0,0,0,0,0,0,0,0,0,0,0,0,0,0,0,4,17,23,18,16,14,6,0,0,0,0,0,0,0,0,0,0,0,0,0,0,0,0,0,0,1,3,6,7,6,5,5,5,3,2,3,3,2,6,10,7,1,0,0,0,0,5,11,9,2,0,0,0,0,0,0,1,3,1,0,0
0,0,0,0,0,0,0,0,0,0,0,0,0,0,0,0,0,0,0,0,0,0,0,0,0,0,0,0,0,0,0,0,0,0,0,0,0,0,0,0,2,7,8,3,0,0,0,0,0,0,0,0,0,0,0,0,0,0,0,0,0,0,0,0,0,0,0,2,3,4,6,7,6,4,3,3,3,5,8,7,3,0,0,0,0,5,11,8,2,0,0,0,0,0,0,1,2,1,0,0
0,0,0,0,0,0,0,0,0,0,0,0,0,0,0,0,0,0,0,0,0,0,0,0,0,0,0,0,0,0,0,0,0,0,0,0,0,0,0,0,0,0,0,0,0,0,0,0,0,0,0,0,0,0,0,0,0,0,0,0,0,0,0,0,0,0,0,0,0,0,3,5,6,5,5,4,4,4,8,9,4,0,0,0,0,5,15,16,6,0,0,0,0,0,1,2,1,0,0,0
0,0,0,0,0,0,0,0,0,0,0,0,0,0,0,0,0,0,0,0,0,0,0,0,0,0,0,0,0,0,0,0,0,0,0,0,0,0,0,0,0,0,0,0,0,0,0,0,0,0,0,0,0,0,0,0,0,0,0,0,0,0,0,0,0,0,0,0,0,0,0,1,3,4,6,7,5,3,7,10,6,0,0,0,0,10,28,28,12,0,0,0,0,0,1,2,1,0,0,0
0,0,0,0,0,0,0,0,0,0,0,0,0,0,0,0,0,0,0,0,0,0,0,0,0,0,0,0,0,0,0,0,0,0,0,0,0,0,0,0,0,0,0,0,0,0,0,0,0,0,0,0,0,0,0,0,0,0,0,0,0,0,0,0,0,0,0,0,0,0,0,0,0,0,4,6,6,5,6,9,8,3,0,0,0,15,35,34,11,0,0,0,0,0,1,2,1,0,0,0
0,0,0,0,0,0,0,0,0,0,0,0,0,0,0,0,0,0,0,0,0,0,0,0,0,0,0,0,0,0,0,0,0,0,0,0,0,0,0,0,0,0,0,0,0,0,0,0,0,0,0,0,0,0,0,0,0,0,0,0,0,0,0,0,0,0,0,0,0,0,0,0,0,0,0,2,5,6,6,8,8,6,1,0,0,15,31,26,8,1,0,0,0,0,1,2,1,0,0,0
0,0,0,0,0,0,0,0,0,0,0,0,0,0,0,0,0,0,0,0,0,0,0,0,0,0,0,0,0,0,0,0,0,0,0,0,0,0,0,0,0,0,0,0,0,0,0,0,0,0,0,0,0,0,0,0,0,0,0,0,0,0,0,0,0,0,0,0,0,0,0,0,0,0,0,0,1,5,6,9,10,8,3,0,0,13,22,20,8,4,0,0,0,0,1,2,1,0,0,0
0,0,0,0,0,0,0,0,0,0,0,0,0,0,0,0,0,0,0,0,0,0,0,0,0,0,0,0,0,0,0,0,0,0,0,0,0,0,0,0,0,0,0,0,0,0,0,0,0,0,0,0,0,0,0,0,0,0,0,0,0,0,0,0,0,0,0,0,0,0,0,0,0,0,0,0,0,1,5,10,11,8,4,2,0,11,18,17,8,5,0,0,0,0,1,2,1,0,0,0
0,0,0,0,0,0,0,0,0,0,0,0,0,0,0,0,0,0,0,0,0,0,0,0,0,0,0,0,0,0,0,0,0,0,0,0,0,0,0,0,0,0,0,0,0,0,0,0,0,0,0,0,0,0,0,0,0,0,0,0,0,0,0,0,0,0,0,0,0,0,0,0,0,0,0,0,0,0,2,8,11,8,5,4,2,10,16,15,7,4,0,0,0,0,1,2,1,0,0,0
0,0,0,0,0,0,0,0,0,0,0,0,0,0,0,0,0,0,0,0,0,0,0,0,0,0,0,0,0,0,0,0,0,0,0,0,0,0,0,0,0,0,0,0,0,0,0,0,0,0,0,0,0,0,0,0,0,0,0,0,0,0,0,0,0,0,0,0,0,0,0,0,0,0,0,0,0,0,0,4,7,8,6,5,5,12,15,13,6,4,0,0,0,0,1,2,1,0,0,0
0,0,0,0,0,0,0,0,0,0,0,0,0,0,0,0,0,0,0,0,0,0,0,0,0,0,0,0,0,0,0,0,0,0,0,0,0,0,0,0,0,0,0,0,0,0,0,0,0,0,0,0,0,0,0,0,0,0,0,0,0,0,0,0,0,0,0,0,0,0,0,0,0,0,0,0,0,0,0,0,5,8,6,4,6,14,16,13,6,6,2,0,0,0,1,2,1,0,0,0
0,0,0,0,0,0,0,0,0,0,0,0,0,0,0,0,0,0,0,0,0,0,0,0,0,0,0,0,0,0,0,0,0,0,0,0,0,0,0,0,0,0,0,0,0,0,0,0,0,0,0,0,0,0,0,4,7,4,0,0,0,0,0,0,0,0,0,0,0,0,0,0,0,0,0,0,0,0,0,0,4,7,5,2,5,16,20,16,9,7,3,1,0,1,2,1,0,0,0,0
0,0,0,0,0,0,0,0,0,0,0,0,0,0,0,0,0,0,0,0,0,0,0,0,0,0,0,0,0,0,0,0,0,0,0,0,0,0,0,0,0,0,0,0,0,0,0,0,0,0,0,0,0,0,0,13,22,15,0,0,0,0,0,0,0,0,0,0,0,0,0,0,0,0,0,0,0,0,0,0,4,8,8,4,5,17,23,18,9,7,3,1,1,2,3,1,0,0,0,0
0,0,0,0,0,0,0,0,0,0,0,0,0,0,0,0,0,0,0,0,0,0,0,0,0,0,0,0,0,0,0,0,0,0,0,0,0,0,0,0,0,0,0,0,0,0,0,0,0,0,0,0,0,0,0,14,26,21,3,0,0,0,0,0,0,0,0,0,0,0,0,0,0,0,0,0,2,3,3,3,6,10,10,6,4,15,23,17,7,5,2,0,0,2,3,2,0,0,0,0
0,0,0,0,0,0,0,4,7,4,0,0,0,0,0,0,0,0,0,0,0,0,0,0,0,0,0,0,0,0,0,0,0,0,0,0,0,0,0,0,0,0,0,0,0,0,0,0,0,0,0,0,0,0,0,6,17,16,7,0,0,0,0,0,0,0,0,0,0,0,2,9,13,12,10,8,6,5,6,7,9,13,14,9,4,13,20,14,6,5,3,0,0,2,5,6,5,2,0,0
0,0,0,0,0,0,0,6,14,16,8,2,0,0,0,0,0,0,0,0,0,0,0,0,0,0,0,0,0,0,0,0,0,0,0,0,0,0,0,0,0,0,0,0,0,0,0,0,0,0,0,0,1,1,0,0,6,14,14,4,0,0,0,0,0,0,0,0,0,0,7,19,24,20,16,12,7,5,6,7,8,12,13,9,4,12,19,16,9,7,4,2,4,5,8,14,14,7,0,0
0,0,0,0,0,0,0,4,13,18,14,8,3,0,0,0,0,0,0,0,0,0,0,0,0,0,0,0,0,0,0,0,0,0,0,0,0,0,0,0,0,0,0,0,0,0,0,0,0,0,3,10,11,5,0,0,2,19,26,15,0,0,0,0,0,0,0,0,0,0,7,17,18,12,10,8,5,3,3,3,2,6,10,8,4,10,17,17,14,13,7,3,6,7,8,15,16,8,0,0
0,0,0,0,0,0,0,0,3,9,11,8,6,4,1,0,0,0,0,0,0,0,0,0,0,0,0,0,0,0,0,0,0,0,0,0,0,0,0,0,0,0,0,0,0,0,0,0,0,0,5,20,24,11,0,0,0,24,37,23,0,0,0,0,0,0,0,0,0,0,4,6,4,0,2,3,3,2,1,0,0,2,5,5,2,9,17,18,17,17,10,3,4,5,4,6,8,4,0,0
0,0,0,0,0,0,0,0,0,0,2,4,6,5,4,2,1,0,0,0,0,0,0,0,0,0,0,0,0,0,0,0,0,0,0,0,0,0,0,0,0,0,0,0,0,0,0,0,0,0,3,18,24,14,0,0,0,19,32,22,1,0,0,0,0,0,0,0,0,0,2,4,4,3,3,3,2,0,0,0,0,2,6,6,3,11,18,15,12,16,13,6,3,2,1,0,1,0,0,0
0,0,0,0,0,0,0,0,0,0,0,0,1,3,4,4,3,2,0,0,0,0,0,0,0,0,0,0,0,0,0,0,0,0,0,0,0,0,0,0,0,0,0,0,0,0,0,0,0,0,0,7,14,11,2,0,0,8,19,16,4,0,0,0,0,0,0,0,0,0,2,4,5,5,7,6,4,3,3,3,3,4,7,8,6,12,17,11,4,11,15,11,5,2,0,1,1,1,0,0
0,0,0,0,0,0,0,0,0,0,0,0,0,0,1,2,3,6,9,6,1,0,0,0,0,0,0,0,0,0,0,4,11,11,4,0,0,0,0,0,0,0,0,0,0,0,0,0,0,0,0,2,14,20,11,0,0,1,8,11,6,4,7,4,0,0,0,0,0,0,1,3,6,8,8,7,8,16,31,34,23,16,17,16,11,14,17,11,4,12,18,16,8,3,0,1,1,1,0,0
0,0,0,0,0,0,0,0,0,0,0,0,0,0,0,0,1,8,15,17,10,3,0,0,0,0,0,0,0,0,0,6,19,24,15,4,0,0,0,0,0,0,0,0,0,0,0,0,0,0,0,0,17,30,24,3,0,0,6,9,6,14,22,14,0,0,0,0,0,0,11,24,21,12,12,10,17,35,51,53,43,33,28,22,13,20,29,25,19,35,48,51,50,57,49,35,23,11,0,0
0,0,0,0,0,0,0,0,0,0,0,0,0,0,0,0,0,3,12,18,18,15,7,1,0,0,0,0,0,0,0,4,14,21,17,11,5,1,0,0,0,0,0,0,0,0,0,0,0,0,0,0,14,34,31,10,0,0,4,7,5,20,30,19,0,0,0,0,0,0,21,34,30,11,10,8,19,30,40,36,36,33,31,23,16,28,37,32,25,43,59,66,72,88,77,60,34,19,0,0
0,0,0,0,0,0,0,0,0,0,0,0,0,0,0,0,0,0,2,7,15,17,14,6,2,0,0,0,0,0,0,0,2,6,10,11,15,19,12,2,0,0,0,0,0,0,0,0,0,0,0,0,6,23,28,13,0,0,1,5,5,14,21,15,2,0,0,0,0,0,11,22,15,5,5,5,10,13,8,4,11,19,23,23,22,31,36,24,13,23,33,37,42,54,49,35,23,11,0,0
0,0,0,0,0,0,0,0,0,0,0,0,0,0,0,0,0,0,0,0,4,9,10,7,6,4,3,3,2,0,0,0,0,0,1,4,18,31,32,14,2,0,0,0,0,0,0,0,0,0,0,0,2,14,19,10,0,0,0,4,6,7,17,22,11,0,0,0,0,0,0,0,0,0,0,0,0,0,0,0,1,6,15,23,26,31,28,13,0,0,0,0,0,0,0,0,0,0,0,0
0,0,0,0,0,0,0,0,0,0,0,0,0,0,0,0,0,0,0,0,0,0,2,5,6,6,5,4,4,3,3,2,2,1,0,0,8,25,31,21,8,2,0,0,0,0,0,0,0,0,0,0,0,7,11,7,0,0,0,4,6,4,24,37,23,0,0,0,0,0,0,0,0,0,0,0,0,0,0,0,0,1,8,18,22,27,26,13,0,0,0,0,0,0,0,0,0,0,0,0
0,0,0,0,0,0,0,0,0,0,0,0,0,0,0,0,0,0,0,0,0,0,0,0,2,3,3,3,3,4,4,4,3,3,2,2,4,10,16,15,11,7,2,0,0,0,0,0,0,0,0,0,0,10,17,11,2,3,4,6,11,11,30,41,26,0,0,0,0,0,0,0,0,0,0,0,0,0,0,0,0,0,4,13,16,24,25,15,0,0,0,0,0,0,0,0,0,0,0,0
0,0,0,0,0,0,0,0,0,0,0,0,0,0,0,0,0,0,0,0,0,0,0,0,0,0,0,0,0,2,3,2,2,2,3,3,8,13,14,8,8,8,6,2,0,0,0,0,0,0,0,0,0,16,31,30,14,10,9,9,22,28,35,31,19,0,0,0,0,0,0,0,0,0,0,0,0,0,0,0,0,1,6,11,12,21,26,16,1,0,0,0,0,0,0,0,0,0,0,0
0,0,0,0,0,0,0,0,0,0,0,0,0,0,0,0,0,0,0,0,0,0,0,0,0,0,0,0,0,0,0,0,0,0,1,2,5,16,19,10,2,5,7,6,3,1,2,4,5,4,4,4,3,15,34,36,21,10,8,8,26,36,35,23,17,4,1,0,0,0,0,0,0,0,0,0,0,0,0,0,0,2,7,9,8,18,26,18,4,0,0,0,0,0,0,0,0,0,0,0
0,0,0,0,0,0,0,0,0,0,0,0,0,0,0,0,0,0,0,0,0,0,0,0,0,0,0,0,0,0,0,0,0,0,0,0,0,9,15,11,2,1,4,6,6,5,7,9,8,8,9,10,9,11,23,29,19,8,7,7,20,29,25,17,18,12,6,3,0,0,0,0,0,0,0,0,0,0,0,0,0,3,8,8,6,16,25,20,7,1,0,0,0,0,0,0,0,0,0,0
0,0,0,0,0,0,0,0,0,0,0,0,0,0,0,0,0,0,0,0,0,0,0,0,0,0,0,0,0,0,0,0,0,0,0,0,0,2,6,7,5,1,1,3,7,12,22,26,20,13,11,11,10,7,11,13,11,6,6,6,11,17,16,14,16,16,20,20,9,0,0,0,0,0,0,0,0,0,0,0,0,3,6,7,5,13,20,20,10,4,0,0,0,0,0,0,0,0,0,0
0,0,0,0,0,0,0,0,0,0,0,0,0,0,0,0,0,0,0,0,0,0,0,0,0,0,0,0,0,0,0,0,0,0,0,0,0,0,1,5,6,3,0,0,6,15,28,30,23,12,8,6,6,6,8,9,8,6,7,7,8,15,16,17,15,17,33,38,20,0,0,0,0,0,0,0,0,0,0,0,0,1,3,5,4,10,16,18,13,7,1,0,0,0,0,0,0,0,0,0
0,0,0,0,0,0,0,0,0,0,0,0,0,0,0,0,0,0,0,0,0,0,0,0,0,0,0,0,0,0,0,0,0,0,0,0,0,0,0,1,4,5,3,2,6,10,16,18,15,9,7,4,3,4,4,4,3,4,4,4,6,13,18,21,20,20,34,41,21,0,0,0,0,0,0,0,0,0,0,0,0,0,1,5,5,8,15,18,14,8,3,0,0,0,0,0,0,0,0,0
0,0,0,0,0,0,0,0,0,0,0,0,0,0,0,0,0,0,0,0,0,0,0,0,0,0,0,0,0,0,0,0,0,0,0,0,0,0,0,0,2,4,5,6,7,5,1,1,3,5,5,4,2,2,3,2,2,2,3,3,3,8,13,19,25,31,45,42,20,0,0,0,0,0,0,0,0,0,0,0,0,0,1,4,6,8,14,16,13,8,4,0,0,0,0,0,0,0,0,0
0,0,0,0,0,0,0,0,0,0,0,0,0,0,0,0,0,0,0,0,0,0,0,0,0,0,0,0,0,0,0,0,0,0,0,0,0,0,0,0,0,2,4,9,11,7,4,5,5,4,3,1,0,0,0,0,0,0,0,0,0,2,8,23,41,48,50,41,18,0,0,0,0,0,0,0,0,0,0,0,0,0,0,3,6,8,14,14,12,8,5,0,0,0,0,0,0,0,0,0
0,0,0,0,0,0,0,0,0,0,0,0,0,0,0,0,0,0,0,0,0,0,0,0,0,0,0,0,0,0,0,0,0,0,0,0,0,0,0,0,0,0,2,9,15,21,20,13,3,1,0,0,0,0,0,0,0,0,0,0,0,0,4,26,46,52,43,34,28,23,17,9,5,2,0,0,0,0,1,1,3,3,1,3,6,9,13,13,11,9,5,0,0,0,0,0,0,0,0,0
0,0,0,0,0,0,0,0,0,0,0,0,0,0,0,0,0,0,0,0,0,0,0,0,0,0,0,0,0,0,0,0,0,0,0,0,0,0,0,0,0,0,0,6,16,31,28,15,0,0,0,0,0,0,0,0,0,0,0,0,0,0,4,19,36,36,31,41,53,49,32,16,9,7,4,1,0,2,3,4,5,5,5,5,8,11,14,12,12,10,5,0,0,0,0,0,0,0,0,0
0,0,0,0,0,0,0,0,0,0,0,0,0,0,0,0,0,0,0,0,0,0,0,0,0,0,0,0,0,0,0,0,0,0,0,0,0,0,0,0,0,0,0,3,15,29,27,10,0,0,0,0,0,0,0,0,0,0,0,0,0,0,3,10,18,24,37,54,64,54,31,18,12,11,10,8,6,4,4,5,5,5,5,8,11,14,14,12,12,10,5,0,0,0,0,0,0,0,0,0
0,0,0,0,0,0,0,0,0,0,0,0,0,0,0,0,0,0,0,0,0,0,0,0,0,0,0,0,0,0,0,0,0,0,0,0,0,0,3,5,5,4,3,6,18,33,29,10,0,0,0,0,0,0,0,0,0,0,0,0,0,0,1,8,15,21,32,45,49,38,27,18,16,15,15,13,13,10,6,6,6,5,4,7,13,17,16,12,12,9,4,0,0,0,0,0,0,0,0,0
0,0,0,0,0,0,0,0,0,0,0,0,0,0,0,0,0,0,0,0,0,0,0,0,0,0,3,11,16,11,3,0,0,0,0,6,12,12,8,8,8,7,6,6,18,38,38,16,0,0,0,0,0,0,0,0,0,0,0,3,10,13,11,13,18,21,20,34,51,55,45,39,35,29,26,25,24,23,23,19,16,14,8,6,11,17,17,15,13,9,3,0,0,0,0,0,0,0,0,0
0,0,0,0,0,0,0,0,0,0,0,0,0,0,0,0,0,0,0,0,0,0,0,0,0,0,5,17,25,19,9,6,5,8,15,25,24,18,9,6,5,4,3,4,9,26,30,14,0,0,0,0,0,0,0,0,0,0,0,6,15,21,17,16,22,25,26,43,57,56,45,41,39,35,32,28,25,29,32,30,27,27,22,15,10,14,17,19,14,8,1,0,0,0,0,0,0,0,0,0
0,0,0,0,0,0,0,0,0,0,0,0,0,0,0,0,0,0,0,0,0,0,0,0,0,0,3,11,16,13,10,9,8,14,24,29,22,10,3,0,0,0,0,0,0,8,12,7,0,0,0,0,0,0,0,0,0,0,0,3,10,13,11,10,21,39,52,48,40,28,21,21,21,20,20,19,15,15,20,23,25,31,31,27,16,13,16,20,15,8,1,0,0,0,0,0,0,0,0,0
0,0,0,0,0,0,0,0,0,0,0,0,0,0,0,0,0,0,0,0,0,0,0,0,0,0,0,0,0,1,4,6,5,8,15,14,5,0,0,0,0,0,0,0,0,2,3,2,0,0,0,0,0,0,0,0,0,0,0,0,0,0,0,1,12,44,59,42,10,0,0,0,0,2,3,3,2,1,2,6,13,21,29,33,25,17,17,21,16,8,2,0,0,0,0,0,0,0,0,0
0,0,0,0,0,0,0,0,0,0,0,0,0,0,0,0,0,0,0,0,0,0,0,0,0,0,0,0,0,0,0,0,0,0,0,0,0,0,0,0,0,0,0,0,0,0,0,0,0,0,0,0,0,0,0,0,0,0,0,0,0,0,0,0,6,32,44,26,3,0,0,0,0,0,0,0,0,0,0,0,3,9,20,31,31,23,20,19,15,9,3,0,0,0,0,0,0,0,0,0
0,0,0,0,0,0,0,0,0,0,0,0,0,0,0,0,0,0,0,0,0,0,0,0,0,0,0,0,0,0,0,0,0,0,0,0,0,0,0,0,0,0,0,0,0,0,0,0,0,0,0,0,0,0,0,0,0,0,0,0,0,0,0,0,6,21,27,16,3,0,0,0,0,0,0,0,0,0,0,0,0,3,11,25,30,28,24,18,13,10,5,0,0,0,0,0,0,0,0,0
0,0,0,0,0,0,0,0,0,0,0,0,0,0,0,0,0,0,0,0,0,0,0,0,0,0,0,0,0,0,0,0,0,0,0,0,0,0,0,0,0,0,0,0,0,0,0,0,0,0,0,0,0,0,0,0,0,0,0,0,0,0,0,0,7,19,25,15,4,0,0,0,0,0,0,0,0,0,0,0,0,0,4,18,29,34,31,21,11,11,7,0,0,0,0,0,0,0,0,0
0,0,0,0,0,0,0,0,0,0,0,0,0,0,0,0,0,0,0,0,0,0,0,0,0,0,0,0,0,0,0,0,0,0,0,0,0,0,0,0,0,0,0,0,0,0,0,0,0,0,0,0,0,0,0,0,0,0,0,0,0,0,0,0,6,24,37,24,6,0,0,0,0,0,0,0,0,0,0,0,0,0,0,13,27,38,36,25,11,10,8,2,0,0,0,0,0,0,0,0
0,0,0,0,0,0,0,0,0,0,0,0,0,0,0,0,0,0,0,0,0,0,0,0,0,0,0,0,0,0,0,0,0,0,0,0,0,0,0,0,0,0,0,0,0,0,0,0,0,0,0,0,0,0,0,0,0,0,0,0,0,0,0,0,3,26,42,33,7,0,0,0,0,0,0,0,0,0,0,0,0,0,1,10,24,35,36,25,13,10,9,3,0,0,0,0,0,0,0,0
0,0,0,0,0,0,0,0,0,0,0,0,0,0,0,0,0,0,0,0,0,0,0,0,0,0,0,0,0,0,0,0,0,0,0,0,0,0,0,0,0,0,0,0,0,0,0,0,0,0,0,0,0,0,0,0,0,0,0,0,0,0,0,0,0,15,32,27,7,0,0,0,0,0,0,0,0,0,0,0,0,0,3,8,20,29,33,25,15,9,8,4,1,0,0,0,0,0,0,0
0,0,0,0,0,0,0,0,0,0,0,0,0,0,0,0,0,0,0,0,0,0,0,0,0,0,0,0,0,0,0,0,0,0,0,0,0,0,0,0,0,0,0,0,0,0,0,0,0,0,0,0,0,0,0,0,0,0,0,0,0,0,0,0,0,3,14,17,8,0,0,0,0,0,0,0,0,0,0,0,0,2,4,6,14,24,32,27,18,9,7,4,2,0,0,0,0,0,0,0
0,0,0,0,0,0,0,0,0,0,0,0,0,0,0,0,0,0,0,0,0,0,0,0,0,0,0,0,0,0,0,0,0,0,0,0,0,0,0,0,0,0,0,0,0,0,0,0,0,0,0,0,0,0,0,0,0,0,0,0,0,0,0,0,0,0,10,16,10,0,0,0,0,0,0,0,0,0,0,0,1,3,3,3,9,21,32,30,19,8,6,4,3,0,0,0,0,0,0,0
0,0,0,0,0,0,0,0,0,0,0,0,0,0,0,0,0,0,0,0,0,0,0,0,0,0,0,0,0,0,0,0,0,0,0,0,0,0,0,0,0,0,0,0,0,0,0,0,0,0,0,0,0,0,0,0,0,0,0,0,0,0,0,0,0,0,24,40,24,0,0,0,0,0,0,0,0,0,0,2,5,5,2,2,8,20,31,34,36,37,39,42,38,22,10,2,0,0,0,0
0,0,0,0,0,0,0,0,0,0,0,0,0,0,0,0,0,0,0,0,0,0,0,0,0,0,0,0,0,0,0,0,0,0,0,0,0,0,0,0,0,0,0,0,0,0,0,0,0,0,0,0,0,0,0,0,0,0,0,0,0,0,0,0,0,0,30,45,30,0,0,0,0,0,0,0,0,0,0,12,24,19,4,2,8,21,43,81,105,79,60,62,59,36,16,4,0,0,0,0
0,0,0,0,0,0,0,0,0,0,0,0,0,0,0,0,0,0,0,0,0,0,0,0,0,0,0,0,0,0,0,0,0,0,0,0,0,0,0,0,0,0,0,0,0,0,0,0,0,0,0,0,0,0,0,0,0,0,0,0,0,0,0,0,0,0,15,27,15,0,0,0,0,0,0,0,0,0,0,17,30,25,7,3,11,27,53,109,120,82,35,39,36,22,10,2,0,0,0,0
0,0,0,0,0,0,0,0,0,0,0,0,0,0,0,0,0,0,0,0,0,0,0,0,0,0,0,0,0,0,0,0,0,0,0,0,0,0,0,0,0,0,0,0,0,0,0,0,0,0,0,0,0,0,0,0,0,0,0,0,0,0,0,0,0,0,0,0,0,0,0,0,0,0,0,0,0,0,0,8,17,15,6,5,14,27,46,73,72,29,0,0,0,0,0,0,0,0,0,0
0,0,0,0,0,0,0,0,0,0,0,0,0,0,0,0,0,0,0,0,0,0,0,0,0,0,0,0,0,0,0,0,0,0,0,0,0,0,0,0,0,0,0,0,0,0,0,0,0,0,0,0,0,0,0,0,0,0,0,0,0,0,0,0,0,0,0,0,0,0,0,0,0,0,0,0,0,0,0,0,0,1,3,5,11,18,21,16,7,0,0,0,0,0,0,0,0,0,0,0
