0,0,0,0,0,0,0,0,0,0,0,0,0,0,0,0,0,0,0,0,0,0,0,0,0,0,0,0,0,0,0,0,0,0,0,0,0,0,0,0,0,0,0,0,0,0,0,0,0,0,0,0,0,0,0,0,0,0,0,0,0,0,0,0,0,0,0,0,0,0,0,0,0,0,0,0,0,0,0,0,0,0,0,0,0,0,0,0,0,0,0,0,0,0,0,0,0,0,0,0
0,0,0,0,0,0,0,0,0,0,0,0,0,0,0,0,0,0,0,0,0,0,0,0,0,0,0,0,0,0,0,0,0,0,0,0,0,0,0,0,0,0,0,0,0,0,0,0,0,0,0,0,0,0,0,0,0,0,0,0,0,0,0,0,0,0,0,0,0,0,0,0,0,0,0,0,0,0,0,0,0,0,0,0,0,0,0,0,0,0,0,0,0,0,0,0,0,0,0,0
0,0,0,0,0,0,0,0,0,0,0,0,0,0,0,0,0,0,0,0,0,0,0,0,0,0,0,0,0,0,0,0,0,0,0,0,0,0,0,0,0,0,0,0,0,0,0,0,0,0,0,0,0,0,0,0,0,0,0,0,0,0,0,0,0,0,0,0,0,0,0,0,0,0,0,0,0,0,0,0,0,0,0,0,0,0,0,0,0,0,0,0,0,0,0,0,0,0,0,0
0,0,0,0,0,0,0,0,0,0,0,0,0,0,0,0,0,0,0,0,0,0,0,0,0,0,0,0,0,0,0,0,0,0,0,0,0,0,0,0,0,0,0,0,0,0,0,0,0,0,0,0,0,0,0,0,0,0,0,0,0,0,0,0,0,0,0,0,0,0,0,0,0,0,0,0,0,0,0,0,0,0,0,0,0,0,0,0,0,0,0,0,0,0,0,0,0,0,0,0
0,0,0,0,0,0,0,0,0,0,2,6,5,2,0,0,0,0,0,0,0,0,0,0,0,0,0,0,0,0,0,0,0,0,0,0,0,0,0,0,0,0,0,0,0,0,0,0,0,0,0,0,0,0,0,0,0,0,0,0,0,0,0,0,0,0,0,0,0,0,0,0,0,0,0,0,0,0,0,0,0,0,0,0,0,0,0,0,0,0,0,0,0,0,0,0,0,0,0,0
0,0,0,0,0,0,0,0,0,0,4,11,15,11,7,10,11,5,0,0,0,0,0,0,0,0,0,0,0,0,0,0,0,0,0,0,0,0,0,0,0,0,0,0,0,0,0,0,0,0,0,0,0,0,0,0,0,0,0,0,0,0,0,0,0,0,0,0,0,0,0,0,0,0,0,0,0,0,0,0,0,0,0,0,0,0,0,0,0,0,0,0,0,0,0,0,0,0,0,0
0,0,0,0,0,0,0,0,0,0,2,9,15,14,11,17,20,18,9,7,5,2,0,0,0,0,0,0,0,0,0,0,0,0,0,0,0,0,0,0,0,0,0,0,0,0,0,0,0,0,0,0,0,0,0,0,0,0,0,0,0,0,0,0,0,0,0,0,0,0,0,0,0,0,0,0,0,0,0,0,0,0,0,0,0,0,0,0,0,0,0,0,0,0,0,0,0,0,0,0
0,0,0,0,0,0,0,0,0,0,0,2,5,8,7,10,17,18,14,11,9,7,12,18,12,2,0,0,0,0,0,0,0,0,0,0,0,0,0,0,0,0,0,0,0,0,0,0,0,0,0,0,0,0,0,0,0,0,0,0,0,0,0,0,0,0,0,0,0,0,0,0,0,0,0,0,0,0,0,0,0,0,0,0,0,0,0,0,0,0,0,0,0,0,0,0,0,0,0,0
0,0,0,0,0,0,0,0,0,0,0,0,0,0,0,0,3,8,9,7,7,7,20,29,25,10,6,3,1,0,0,0,0,0,0,0,0,0,0,0,0,0,0,0,0,4,9,7,2,0,0,0,0,0,0,0,0,0,0,0,0,0,0,0,0,0,0,0,0,0,0,0,0,0,0,0,0,0,0,0,0,0,0,0,0,0,0,0,0,0,0,0,0,0,0,0,0,0,0,0
0,0,0,0,0,0,0,0,0,0,0,0,0,0,0,0,0,0,0,0,1,3,12,21,20,13,10,8,6,4,2,0,0,0,0,0,0,0,0,0,0,0,0,0,0,7,15,16,10,5,2,0,0,0,0,0,0,0,0,0,0,0,0,0,0,0,0,0,0,0,0,0,0,0,0,0,0,0,0,0,0,0,0,0,0,0,0,0,0,0,0,0,0,0,0,0,0,0,0,0
0,0,0,0,0,0,0,0,0,0,0,0,0,0,0,0,0,0,0,0,0,0,0,1,5,7,7,7,7,7,6,5,3,1,0,0,0,0,0,0,0,0,0,0,0,4,11,14,12,9,11,14,10,2,0,0,0,0,0,0,0,0,0,0,0,0,0,0,0,0,0,0,0,0,0,0,0,0,0,0,0,0,0,0,0,0,0,0,0,0,0,0,0,0,0,0,0,0,0,0
0,0,0,0,0,0,0,0,0,0,0,0,0,0,0,0,0,0,0,0,0,0,0,0,0,0,0,2,4,5,5,6,6,5,4,3,1,0,0,0,0,0,0,0,0,0,1,4,6,7,16,22,19,10,6,3,0,0,0,0,0,0,0,0,0,0,0,0,0,1,4,6,6,7,7,3,0,0,0,0,0,0,0,0,0,0,0,0,0,0,0,0,0,0,0,0,0,0,0,0
0,0,0,0,0,0,0,0,0,0,0,0,0,0,0,0,0,0,0,0,0,0,0,0,0,0,0,0,0,0,1,3,4,5,5,5,4,4,3,1,0,0,0,0,0,0,0,0,0,1,8,15,15,11,10,7,9,11,8,2,0,0,0,0,0,0,0,0,0,3,8,11,10,17,20,12,1,0,0,0,0,0,0,0,0,0,0,0,0,0,0,0,0,0,0,0,0,0,0,0
0,0,0,0,0,0,0,0,0,0,0,0,0,0,0,0,0,0,0,0,0,0,0,0,0,0,0,0,0,0,0,0,0,1,3,3,4,5,5,3,3,2,1,0,0,0,0,0,0,0,0,0,2,5,6,7,13,23,23,9,0,0,0,0,0,0,0,0,1,6,9,9,7,16,24,20,7,1,0,0,0,0,0,0,0,0,0,0,0,0,0,0,0,0,0,0,0,0,0,0
0,0,0,0,0,0,0,0,0,0,0,0,0,0,0,0,0,0,0,0,0,0,0,0,0,0,0,0,0,0,0,0,0,0,0,0,1,3,3,3,4,4,4,3,2,0,0,0,0,0,0,0,0,0,0,2,7,22,27,17,2,0,0,0,0,0,0,0,4,9,10,6,5,10,21,23,16,7,3,3,2,1,0,0,0,0,0,0,0,0,0,0,0,0,0,0,0,0,0,0
0,0,0,0,0,0,0,0,0,0,0,0,0,0,0,0,0,0,0,0,0,0,0,0,0,0,0,0,0,0,0,0,0,0,0,0,0,0,0,1,2,4,4,5,4,3,3,2,0,0,0,0,0,0,0,0,0,7,17,17,10,5,2,0,0,0,0,3,12,16,12,8,10,12,18,22,19,12,7,4,4,3,2,0,0,0,0,0,0,0,0,0,0,0,0,0,0,0,0,0
0,0,0,0,0,0,0,0,0,0,0,0,0,0,0,0,0,0,0,0,0,0,0,0,0,0,0,0,0,0,0,0,0,0,0,0,0,0,0,0,0,0,2,3,3,4,4,4,3,3,2,1,0,0,0,0,0,1,5,10,12,9,7,5,4,5,10,18,21,19,13,9,10,12,16,18,18,16,13,9,7,7,5,2,0,0,0,0,0,0,0,0,0,0,0,0,0,0,0,0
0,0,0,0,0,0,0,0,0,0,0,0,0,0,0,0,0,0,0,0,0,0,0,0,0,0,0,0,0,0,0,0,0,0,0,0,0,0,0,0,0,0,0,0,0,2,3,3,4,5,5,4,3,3,3,3,3,3,3,6,8,9,10,10,14,25,35,30,21,13,9,7,5,4,10,14,15,15,15,11,9,10,8,5,1,0,0,0,0,0,0,0,0,0,0,0,0,0,0,0
0,0,0,0,0,0,0,0,0,0,0,0,0,0,0,0,0,0,0,0,0,0,0,0,0,0,0,0,0,0,0,0,0,0,0,0,0,0,0,0,0,0,0,0,2,3,2,3,4,9,14,13,10,9,9,8,8,7,7,7,6,7,10,12,18,32,38,26,8,3,4,3,1,0,5,10,10,10,11,10,8,10,11,7,2,0,0,0,0,0,0,0,0,0,0,0,0,0,0,0
0,0,0,0,0,0,0,0,0,0,0,0,0,0,0,0,0,0,0,0,0,0,0,0,0,0,0,0,0,0,0,0,0,0,0,0,0,0,2,6,7,6,4,4,4,5,4,3,4,10,15,16,11,10,10,9,8,7,7,7,7,7,7,8,10,17,18,7,0,0,0,0,0,0,3,6,3,1,5,5,4,7,10,10,5,1,0,0,0,0,0,0,0,0,0,0,0,0,0,0
0,0,0,0,0,0,0,0,0,0,0,0,0,0,0,0,0,0,0,0,0,0,0,0,0,0,0,0,0,0,0,0,0,0,0,0,0,0,4,10,12,9,7,5,4,3,2,2,2,6,9,8,5,4,4,4,3,3,3,3,3,3,3,3,2,0,0,0,0,0,0,0,0,0,3,5,3,0,4,6,3,2,7,11,9,3,0,0,5,9,5,0,0,0,0,0,0,0,0,0
0,0,0,0,0,0,0,0,0,0,0,0,0,0,0,0,0,0,0,0,0,0,0,0,0,0,0,0,0,0,0,0,0,0,0,0,0,0,2,6,7,6,4,3,1,0,0,0,0,0,0,0,0,0,0,0,0,0,0,0,0,0,0,0,0,0,0,0,0,0,0,0,0,0,3,5,3,0,3,5,4,0,3,8,10,6,1,0,11,17,11,0,0,0,0,0,0,0,0,0
0,0,0,0,0,0,0,0,0,0,0,0,0,0,0,0,0,0,0,0,0,0,0,0,0,0,0,0,0,0,0,0,0,0,0,0,0,0,0,0,0,0,0,0,0,0,0,0,0,0,0,0,0,0,0,0,0,0,0,0,0,0,0,0,0,0,0,0,0,0,0,0,0,0,1,3,3,1,2,4,4,1,0,5,10,8,2,0,10,17,10,0,0,0,0,0,0,0,0,0
0,0,0,0,0,0,0,0,0,0,0,0,0,0,0,0,0,0,0,0,0,0,0,0,0,0,0,0,0,0,0,0,0,0,0,0,0,0,0,0,0,0,0,0,0,0,0,0,0,0,0,0,0,0,0,0,0,0,0,0,0,0,0,0,0,0,0,0,0,0,0,0,0,0,0,3,4,2,0,4,5,3,0,3,8,9,4,0,6,10,6,0,0,0,0,0,0,0,0,0
0,0,0,0,0,0,0,0,0,0,0,0,0,0,0,0,0,0,0,0,0,0,0,0,0,0,0,0,0,0,0,0,0,0,0,0,0,0,0,0,0,0,0,0,0,0,0,0,0,0,0,0,0,0,0,0,0,0,0,0,0,0,0,0,0,0,0,0,0,0,0,0,0,0,0,2,4,2,0,3,5,3,0,1,6,8,6,2,5,8,5,0,0,0,0,0,0,0,0,0
0,0,0,0,0,0,0,0,0,0,0,0,0,0,0,0,0,0,0,0,0,0,0,0,0,0,0,0,0,0,0,0,0,0,0,0,0,0,0,0,0,0,0,0,0,0,0,0,0,0,0,0,0,0,0,0,0,0,0,0,0,0,0,0,0,0,0,0,0,0,0,0,0,0,0,2,3,2,0,3,5,3,0,0,4,8,8,3,4,7,4,0,0,0,0,0,0,0,0,0
0,0,0,0,0,0,0,0,0,0,0,0,0,0,0,0,0,0,0,0,0,0,0,0,0,0,0,0,0,0,0,0,0,0,0,0,0,0,0,0,0,0,0,0,0,0,0,0,0,0,0,0,0,0,0,0,0,0,0,0,0,0,0,0,0,0,0,0,0,0,0,0,0,0,0,2,4,2,0,3,4,3,0,0,3,8,8,3,4,7,4,0,0,0,0,0,0,0,0,0
0,0,0,0,0,0,0,0,0,0,0,0,0,0,0,0,0,0,0,0,0,0,0,0,0,0,0,0,0,0,0,0,0,0,0,0,0,0,0,0,0,0,0,0,0,0,0,0,0,0,0,0,0,0,0,0,0,0,0,0,0,0,0,0,0,0,0,0,0,0,0,0,0,0,0,3,4,3,0,2,4,3,0,0,3,8,8,3,4,6,4,0,0,0,0,0,0,0,0,0
0,0,0,0,0,0,0,0,0,0,0,0,0,0,0,0,0,0,0,0,0,0,0,0,0,0,0,0,0,0,0,0,0,0,0,0,0,0,0,0,0,0,0,0,0,0,0,0,0,0,0,0,0,0,0,0,0,0,0,0,0,0,0,0,0,0,0,0,0,0,0,0,0,0,0,2,4,2,0,1,3,3,1,0,1,6,8,4,3,6,3,0,0,0,0,0,0,0,0,0
0,0,0,0,0,0,0,0,0,0,0,0,0,0,0,0,0,0,0,0,0,0,0,0,0,0,0,0,0,0,0,0,0,0,0,0,0,0,0,0,0,0,0,0,0,0,0,0,0,0,0,0,0,0,0,0,0,0,0,0,0,0,0,0,0,0,0,0,0,0,0,0,0,0,0,1,3,2,0,0,3,4,2,0,0,6,9,5,3,5,3,0,0,0,0,0,0,0,0,0
0,0,0,0,0,0,0,0,0,0,0,0,0,0,0,0,0,0,0,0,0,0,0,0,0,0,0,0,0,0,0,0,0,0,0,0,0,0,0,0,0,0,0,0,0,0,0,0,0,0,0,0,0,0,0,0,0,0,0,0,0,0,0,0,0,0,0,0,0,0,0,0,0,0,0,0,2,3,1,0,3,4,3,0,0,6,9,6,3,5,3,0,0,0,0,0,0,0,0,0
0,0,0,0,0,0,0,0,0,0,0,0,0,0,0,0,0,0,0,0,0,0,0,0,0,0,0,0,0,0,0,0,0,0,0,0,0,0,0,0,0,0,0,0,0,0,0,0,0,0,0,0,0,0,0,0,0,0,0,0,0,0,0,0,0,0,0,0,0,0,0,0,0,0,0,0,2,3,2,0,3,4,3,0,0,6,9,6,3,4,2,0,0,0,0,0,0,0,0,0
0,0,0,0,0,0,0,0,0,0,0,0,0,0,0,0,0,0,0,0,0,0,0,0,0,0,0,0,0,0,0,0,0,0,0,0,0,0,0,0,0,0,0,0,0,0,0,0,0,0,0,0,0,0,0,0,0,0,0,0,0,0,0,0,0,0,0,0,0,0,0,0,0,0,0,0,2,3,2,0,3,4,3,0,0,5,8,7,3,3,1,0,0,0,0,0,0,0,0,0
0,0,0,0,0,0,0,0,0,0,1,5,8,6,2,0,0,0,0,0,0,0,0,0,0,0,0,0,0,0,0,0,0,0,0,0,0,0,0,0,0,0,0,0,0,0,0,0,0,0,0,0,0,0,0,0,0,0,0,0,0,0,0,0,0,0,0,0,0,0,0,0,0,0,0,0,2,3,2,0,3,4,3,0,0,5,8,7,4,3,0,0,0,0,0,0,0,0,0,0
0,0,0,0,0,0,0,0,0,0,2,8,12,10,9,14,12,4,0,0,0,0,0,0,0,0,0,0,0,0,0,0,0,0,0,0,0,0,0,0,0,0,0,0,0,0,0,0,0,0,0,0,0,0,0,0,0,0,0,0,0,0,0,0,0,0,0,0,0,0,0,0,0,0,0,0,2,3,2,0,3,4,3,0,0,5,7,7,4,3,0,0,0,0,0,0,0,0,0,0
0,0,0,0,0,0,0,0,0,0,1,5,8,7,12,21,22,13,5,2,0,0,0,0,0,0,0,0,0,0,0,0,0,0,0,0,0,0,0,0,0,0,0,0,0,0,3,6,5,1,0,0,0,0,0,0,0,0,0,0,1,1,1,1,1,1,0,0,0,0,0,0,0,0,0,0,1,3,1,0,3,4,3,0,1,5,6,6,4,3,0,0,0,0,0,0,0,0,0,0
0,0,0,0,0,0,0,0,0,0,0,0,0,0,6,14,17,13,9,6,4,2,0,0,0,0,0,0,0,0,1,2,3,3,3,3,3,2,2,2,2,2,1,1,2,1,7,12,12,9,10,12,12,9,5,4,4,3,3,2,2,2,2,2,2,2,2,1,2,1,0,0,0,0,0,0,1,2,2,0,3,4,3,0,2,6,6,5,4,3,0,0,0,0,0,0,0,0,0,0
0,0,0,0,0,0,0,0,0,0,0,0,0,0,0,0,3,6,6,6,6,4,3,3,2,1,5,11,10,6,5,5,5,4,4,4,4,4,3,3,3,3,3,3,3,3,5,10,11,15,18,21,20,17,11,9,9,9,9,7,6,4,3,2,2,2,2,3,3,3,2,1,1,0,0,0,0,2,3,1,3,4,3,0,1,6,6,5,4,2,0,0,0,0,0,0,0,0,0,0
0,0,0,0,0,0,0,0,0,0,0,0,0,0,0,0,0,0,0,2,3,4,4,4,4,3,15,25,22,11,7,5,3,3,3,3,3,2,2,2,2,2,1,1,2,1,1,3,15,29,29,22,20,17,13,11,11,10,9,9,8,7,6,6,4,4,3,2,2,2,3,3,2,2,1,1,0,1,3,1,3,4,3,0,2,5,5,4,3,2,0,0,0,0,0,0,0,0,0,0
0,0,0,0,0,0,0,0,0,0,0,0,0,0,0,0,0,0,0,0,0,0,2,3,3,3,15,23,20,8,4,1,0,0,0,0,0,0,0,0,0,0,0,0,0,1,4,6,20,30,28,14,11,9,9,8,7,5,4,4,6,6,7,8,7,7,6,4,3,3,2,1,2,3,3,2,1,1,2,1,3,4,3,1,3,4,4,4,3,2,0,0,0,0,0,0,0,0,0,0
0,0,0,0,0,0,0,0,0,0,0,0,0,0,0,0,0,0,0,0,0,0,0,0,0,1,5,8,5,1,0,0,0,0,0,0,0,0,0,0,0,0,0,1,3,6,7,7,13,19,15,8,6,4,4,4,2,0,0,0,1,2,3,4,5,5,6,7,6,5,3,1,1,2,2,2,2,11,17,9,2,4,2,1,3,4,4,4,3,2,0,0,0,0,0,0,0,0,0,0
0,0,0,0,0,0,0,0,0,0,0,0,0,0,0,0,0,0,0,0,0,0,0,0,0,0,0,0,0,0,0,0,0,0,0,0,0,0,0,0,0,0,2,7,10,8,6,4,1,0,0,0,0,0,0,0,0,0,0,0,0,0,0,0,0,1,3,5,6,6,4,3,3,2,1,1,2,19,28,20,3,3,2,2,2,4,4,4,3,2,0,0,0,0,0,0,0,0,0,0
0,0,0,0,0,0,0,0,0,0,0,0,0,0,0,0,0,0,0,0,0,0,0,0,0,0,0,0,0,0,0,0,0,0,0,0,0,0,0,4,12,19,23,20,13,6,1,0,0,0,0,0,0,0,0,0,0,0,0,0,0,0,0,0,0,0,0,1,2,3,4,4,4,4,3,2,1,12,24,19,8,4,3,2,2,3,3,4,3,2,0,0,0,0,0,0,0,0,0,0
0,0,0,0,0,0,0,0,0,0,0,0,0,0,0,0,0,0,0,0,0,0,0,0,0,0,0,0,0,0,0,0,0,0,0,0,0,0,0,7,19,30,31,23,9,1,0,0,0,0,0,0,0,0,0,0,0,0,0,0,0,0,0,0,0,0,0,0,0,1,2,3,3,4,4,4,2,2,9,13,11,7,5,3,2,3,4,4,3,2,0,0,0,0,0,0,0,0,0,0
0,0,0,0,0,0,0,0,0,0,0,0,0,0,0,0,0,0,0,0,0,0,0,0,0,0,0,0,0,0,0,0,0,0,0,0,0,0,0,4,12,19,18,11,2,0,0,0,0,0,0,0,0,0,0,0,0,0,0,0,0,0,0,0,0,0,0,0,0,0,1,2,2,3,3,3,3,3,7,10,9,7,8,5,1,2,4,4,3,2,0,0,0,0,0,0,0,0,0,0
0,0,0,0,0,0,0,0,0,0,0,0,0,0,0,0,0,0,0,0,0,0,0,0,0,0,0,0,0,0,0,0,0,0,0,0,0,0,0,0,0,0,0,0,0,0,0,0,0,0,0,0,0,0,0,0,0,0,0,0,0,0,0,0,0,0,0,0,0,0,0,0,2,2,2,1,3,3,7,9,6,7,10,8,1,2,3,8,11,6,0,0,0,0,0,0,0,0,0,0
0,0,0,0,0,0,0,0,0,0,0,0,0,0,0,0,0,0,0,0,0,0,0,0,0,0,0,0,0,0,0,0,0,0,0,0,0,0,0,0,0,0,0,0,0,0,0,0,0,0,0,0,0,0,0,0,0,0,0,0,0,0,0,0,0,0,0,0,0,0,0,0,0,2,2,2,2,2,5,9,7,8,10,9,3,3,4,14,18,11,0,0,0,0,0,0,0,0,0,0
0,0,0,0,0,0,0,0,0,0,0,0,0,0,0,0,0,0,0,0,0,0,0,0,0,0,0,0,0,0,0,0,0,0,0,0,0,0,0,0,0,0,0,0,0,0,0,0,0,0,0,0,0,0,0,0,0,0,0,0,0,0,0,0,0,0,0,0,0,0,0,0,0,0,1,3,2,1,2,8,10,10,8,7,3,10,13,19,18,11,0,0,0,0,0,0,0,0,0,0
0,0,0,0,0,0,0,0,0,0,0,0,0,0,0,0,0,0,0,0,0,0,0,0,0,0,0,0,0,0,0,0,0,0,0,0,0,0,0,0,0,0,0,0,0,0,0,0,0,0,0,0,0,0,0,0,0,0,0,0,0,0,0,0,0,0,0,0,0,0,0,0,0,0,0,1,2,2,1,6,10,11,8,4,2,16,22,21,12,7,0,0,0,0,0,0,0,0,0,0
0,0,0,0,0,0,0,0,0,0,0,0,0,0,0,0,0,0,0,0,0,0,0,0,0,0,0,0,0,0,0,0,0,0,0,0,0,0,0,0,0,0,0,0,0,0,0,0,0,0,0,0,0,0,0,0,0,0,0,0,0,0,0,0,0,0,0,0,0,0,0,0,0,0,0,0,1,2,2,4,8,11,9,4,1,16,24,20,9,6,0,0,0,0,0,0,0,0,0,0
0,0,0,0,0,0,0,0,0,0,0,0,0,0,0,0,0,0,0,0,0,0,0,0,0,0,0,0,0,0,0,0,0,0,0,0,0,0,0,0,0,0,0,0,0,0,0,0,0,0,0,0,0,0,0,0,0,0,0,0,0,0,0,0,0,0,0,0,0,0,0,0,0,0,0,0,0,1,2,4,6,9,10,7,2,11,18,17,8,4,0,0,0,0,0,0,0,0,0,0
0,0,0,0,0,0,0,0,0,0,0,0,0,0,0,0,0,0,0,0,0,0,0,0,0,0,0,0,0,0,0,0,0,0,0,0,0,0,0,0,0,0,0,0,0,0,0,0,0,0,0,0,0,0,0,0,0,0,0,0,0,0,0,0,0,0,0,0,0,0,0,0,0,0,0,0,0,0,1,4,7,8,9,8,5,9,15,15,8,4,0,0,0,0,0,0,0,0,0,0
0,0,0,0,0,0,0,0,0,0,0,0,0,0,0,0,0,0,0,0,0,0,0,0,0,0,0,0,0,0,0,0,0,0,0,0,0,0,0,0,0,0,0,0,0,0,0,0,0,0,0,0,0,0,0,0,0,0,0,0,0,0,0,0,0,0,0,0,0,0,0,0,0,0,0,0,0,0,1,4,8,8,7,8,7,9,13,14,9,5,0,0,0,0,0,0,0,0,0,0
0,0,0,0,0,0,0,0,0,0,0,0,0,0,0,0,0,0,0,0,0,0,0,0,0,0,0,0,0,0,0,0,0,0,0,0,0,0,0,0,0,0,0,0,0,0,0,0,0,0,0,0,0,0,0,0,0,0,0,0,0,0,0,0,0,0,0,0,0,0,0,0,0,0,0,0,0,0,0,3,8,8,6,6,6,10,13,13,9,6,0,0,0,0,0,0,0,0,0,0
0,0,0,0,0,0,0,0,0,0,0,0,0,0,0,0,0,0,0,0,0,0,0,0,0,0,0,0,0,0,0,0,0,0,0,0,0,0,0,0,0,0,0,0,0,0,0,0,0,0,0,0,0,0,0,0,4,9,7,1,0,0,0,0,0,0,0,0,0,0,0,0,0,0,0,0,0,0,0,2,6,8,7,5,5,11,14,11,8,7,2,0,0,0,0,0,0,0,0,0
0,0,0,0,0,0,0,0,0,0,0,0,0,0,0,0,0,0,0,0,0,0,0,0,0,0,0,0,0,0,0,0,0,0,0,0,0,0,0,0,0,0,0,0,0,0,0,0,0,0,0,0,0,0,0,0,9,17,16,6,0,0,0,0,0,0,0,0,0,0,0,0,0,0,0,0,0,0,1,2,5,7,6,5,5,11,13,10,6,7,4,0,0,0,0,0,0,0,0,0
0,0,0,0,0,0,0,0,0,0,0,0,0,0,0,0,0,0,0,0,0,0,0,0,0,0,0,0,0,0,0,0,0,0,0,0,0,0,0,0,0,0,0,0,0,0,0,0,0,0,0,0,0,0,0,0,5,14,15,10,3,0,0,0,0,0,0,0,0,0,0,0,0,0,0,0,0,0,1,3,3,5,5,6,6,11,13,9,6,7,5,0,0,0,0,0,0,0,0,0
0,0,0,0,0,0,0,0,0,0,0,0,0,0,0,0,0,0,0,0,0,0,0,0,0,0,0,0,0,0,0,0,0,0,0,0,0,0,0,0,0,0,0,0,0,0,0,0,0,0,0,0,0,0,0,0,0,2,8,14,13,5,0,0,0,0,0,0,0,0,0,0,0,0,0,0,0,0,2,3,2,3,5,6,6,11,13,9,5,7,6,1,0,0,0,0,0,0,0,0
0,0,0,0,0,0,0,3,6,4,0,0,0,0,0,0,0,0,0,0,0,0,0,0,0,0,0,0,0,0,0,0,0,0,0,0,0,0,0,0,0,0,0,0,0,0,0,0,0,0,0,0,4,6,4,0,0,0,2,15,21,14,2,0,0,0,0,0,0,0,0,0,0,0,0,0,0,0,1,3,1,2,5,5,6,11,12,8,6,8,6,1,0,0,0,0,0,0,0,0
0,0,0,0,0,0,0,6,11,11,4,1,0,0,0,0,0,0,0,0,0,0,0,0,0,0,0,0,0,0,0,0,0,0,0,0,0,0,0,0,0,0,0,0,0,0,0,0,0,0,0,0,9,14,10,0,0,0,0,9,19,16,6,0,0,0,0,0,0,0,0,0,0,0,0,0,0,0,1,2,1,2,4,4,5,11,12,7,6,9,6,2,0,0,0,0,0,0,0,0
0,0,0,0,0,0,0,3,9,10,7,5,2,0,0,0,0,0,0,0,0,0,0,0,0,0,0,0,0,0,0,0,0,0,0,0,0,0,0,0,0,0,0,0,0,0,0,0,0,0,0,0,8,16,13,3,0,0,0,2,7,12,10,3,0,0,0,0,0,0,0,0,0,0,0,0,0,1,2,2,0,2,3,3,3,12,14,8,6,9,7,3,1,0,0,0,0,0,0,0
0,0,0,0,0,0,0,0,1,4,5,5,5,3,1,0,0,0,0,0,0,0,0,0,0,0,0,0,0,0,0,0,0,0,0,0,0,0,0,0,0,0,0,0,0,0,0,0,0,0,0,0,2,9,11,7,1,0,0,0,1,9,12,7,0,0,0,0,0,0,0,0,0,0,0,0,0,2,3,2,0,2,3,3,2,11,15,9,4,8,9,5,2,0,0,0,0,0,0,0
0,0,0,0,0,0,0,0,0,0,1,2,4,4,4,2,0,0,0,0,0,0,0,0,0,0,0,0,0,0,0,0,0,0,0,0,0,0,0,0,0,0,0,0,0,0,0,0,0,0,0,0,0,3,8,8,4,0,0,0,0,5,21,26,11,0,0,0,0,0,0,0,0,0,0,0,0,1,3,1,0,2,3,2,2,11,15,9,2,7,10,7,2,0,0,0,0,0,0,0
0,0,0,0,0,0,0,0,0,0,0,0,1,3,4,3,2,2,1,0,0,0,0,0,0,0,0,0,0,0,0,0,0,0,0,0,0,0,0,0,0,0,0,0,0,0,0,0,0,0,0,0,0,0,4,11,13,5,0,0,0,2,26,36,24,0,0,0,0,0,0,0,0,0,0,0,0,1,3,1,0,1,2,2,2,10,15,10,1,6,10,8,3,1,0,0,0,0,0,0
0,0,0,0,0,0,0,0,0,0,0,0,0,0,1,2,3,3,3,1,0,0,0,0,0,0,0,0,0,0,0,3,8,7,2,0,0,0,0,0,0,0,0,0,0,0,0,0,0,0,0,0,0,0,1,13,19,13,0,0,0,4,22,33,21,3,0,0,0,0,0,0,0,0,0,0,0,12,30,39,32,18,7,5,6,12,18,14,6,7,9,8,4,2,0,0,0,0,0,0
0,0,0,0,0,0,0,0,0,0,0,0,0,0,0,0,1,2,3,5,8,7,2,0,0,0,0,0,0,0,0,6,13,15,9,4,1,0,0,0,0,0,0,0,0,0,0,0,0,0,0,0,0,0,0,9,18,14,3,0,0,10,17,19,11,6,0,0,0,0,0,0,0,0,0,9,21,37,52,72,64,41,21,14,10,12,27,34,29,29,35,44,42,24,8,22,29,15,0,0
0,0,0,0,0,0,0,0,0,0,0,0,0,0,0,0,0,0,1,6,12,13,8,2,0,0,0,0,0,0,0,3,10,13,11,8,6,3,0,0,0,0,0,0,0,0,0,0,0,0,0,0,0,0,0,2,10,11,5,0,0,11,19,18,10,7,0,0,0,0,0,0,0,0,0,16,31,39,42,54,53,38,26,22,12,13,37,47,43,38,47,64,60,38,14,37,43,27,0,0
0,0,0,0,0,0,0,0,0,0,0,0,0,0,0,0,0,0,0,3,8,10,8,7,3,1,0,0,0,0,0,0,0,3,6,7,7,11,11,5,0,0,0,0,0,0,0,0,0,0,0,0,0,0,0,0,5,9,7,1,0,7,13,14,11,8,2,0,0,0,0,0,0,0,0,9,20,17,8,10,13,12,17,20,15,17,33,39,27,22,27,37,38,22,8,22,29,15,0,0
0,0,0,0,0,0,0,0,0,0,0,0,0,0,0,0,0,0,0,0,0,2,5,6,5,4,2,0,0,0,0,0,0,0,0,2,4,14,19,15,3,0,0,0,0,0,0,0,0,0,0,0,0,0,0,0,2,7,7,3,0,2,8,10,12,10,5,0,0,0,0,0,0,0,0,0,0,0,0,0,0,0,6,16,21,23,26,20,7,0,0,0,0,0,0,0,0,0,0,0
0,0,0,0,0,0,0,0,0,0,0,0,0,0,0,0,0,0,0,0,0,0,0,2,4,4,4,3,1,0,0,0,0,0,0,0,0,7,16,16,9,2,0,0,0,0,0,0,0,0,0,0,0,3,4,4,4,19,29,19,2,0,10,17,17,11,7,0,0,0,0,0,0,0,0,0,0,0,0,0,0,0,4,15,23,23,21,15,6,0,0,0,0,0,0,0,0,0,0,0
0,0,0,0,0,0,0,0,0,0,0,0,0,0,0,0,0,0,0,0,0,0,0,0,0,2,3,3,3,2,0,0,0,0,0,0,0,0,3,10,10,7,2,0,0,0,0,1,4,6,6,5,5,6,7,7,7,27,40,33,9,4,17,23,21,9,6,0,0,0,0,0,0,0,0,0,0,0,0,0,0,0,7,17,22,19,19,13,6,0,0,0,0,0,0,0,0,0,0,0
0,0,0,0,0,0,0,0,0,0,0,0,0,0,0,0,0,0,0,0,0,0,0,0,0,0,0,2,3,3,2,0,0,0,0,0,0,0,0,2,6,8,13,15,8,0,0,3,8,10,10,8,7,6,5,4,4,15,30,27,13,6,16,24,21,10,5,0,0,0,0,0,0,0,0,0,0,0,0,0,0,0,11,19,19,15,20,15,6,0,0,0,0,0,0,0,0,0,0,0
0,0,0,0,0,0,0,0,0,0,0,0,0,0,0,0,0,0,0,0,0,0,0,0,0,0,0,0,1,3,7,13,12,4,0,0,0,0,0,0,1,5,24,31,19,0,1,5,7,7,6,8,9,8,6,6,6,7,13,19,17,8,8,15,20,15,8,3,1,0,0,0,0,0,0,0,0,0,0,0,0,0,11,19,15,14,22,17,5,0,0,0,0,0,0,0,0,0,0,0
0,0,0,0,0,0,0,0,0,0,0,0,0,0,0,0,0,0,0,0,0,0,0,0,0,0,0,0,0,0,9,21,23,12,2,0,0,0,0,0,0,1,19,30,24,6,6,9,9,7,7,9,10,10,10,10,10,11,13,19,20,15,9,13,20,19,15,12,6,0,0,0,0,0,0,0,0,0,0,0,0,0,9,16,11,11,20,18,5,0,0,0,0,0,0,0,0,0,0,0
0,0,0,0,0,0,0,0,0,0,0,0,0,0,0,0,0,0,0,0,0,0,0,0,0,0,0,0,0,0,4,13,18,12,6,2,0,0,0,0,0,0,5,13,16,12,13,15,15,12,12,10,9,6,6,6,6,7,7,11,18,21,16,27,40,36,28,22,9,0,0,0,0,0,0,0,0,0,0,0,0,0,8,14,9,8,18,18,8,1,0,0,0,0,0,0,0,0,0,0
0,0,0,0,0,0,0,0,0,0,0,0,0,0,0,0,0,0,0,0,0,0,0,0,0,0,0,0,0,0,0,0,3,6,6,6,3,1,0,0,0,0,0,2,7,11,14,16,14,10,8,5,2,0,0,0,0,0,0,1,9,15,17,38,56,57,38,28,10,0,0,0,0,0,0,0,0,0,0,0,0,0,5,11,10,8,17,20,10,1,0,0,0,0,0,0,0,0,0,0
0,0,0,0,0,0,0,0,0,0,0,0,0,0,0,0,0,0,0,0,0,0,0,0,0,0,0,0,0,0,0,0,0,1,3,5,5,3,1,0,0,0,0,0,0,4,11,12,7,2,0,0,0,0,0,0,0,0,0,0,2,7,10,29,52,55,46,30,10,0,0,0,0,0,0,0,0,0,0,0,0,0,3,10,10,9,14,19,11,3,0,0,0,0,0,0,0,0,0,0
0,0,0,0,0,0,0,0,0,0,0,0,0,0,0,0,0,0,0,0,0,0,0,0,0,0,0,0,0,0,0,0,0,0,0,1,3,4,4,2,0,0,0,0,0,4,10,9,3,0,0,0,0,0,0,0,0,0,0,0,0,5,7,15,32,55,60,43,14,0,0,0,0,0,0,0,0,0,0,0,0,0,1,7,10,9,13,18,12,4,0,0,0,0,0,0,0,0,0,0
0,0,0,0,0,0,0,0,0,0,0,0,0,0,0,0,0,0,0,0,0,0,0,0,0,0,0,0,0,0,0,0,0,0,0,0,0,3,5,5,2,0,0,0,0,7,13,9,0,0,0,0,0,0,0,0,0,0,0,0,0,3,6,13,32,58,68,45,15,0,0,0,0,0,0,0,0,0,0,0,0,0,0,6,9,10,13,17,12,5,1,0,0,0,0,0,0,0,0,0
0,0,0,0,0,0,0,0,0,0,0,0,0,0,0,0,0,0,0,0,0,0,0,0,0,0,0,0,0,0,0,0,0,0,0,0,0,0,3,4,5,4,4,2,2,12,17,10,0,0,0,0,0,0,0,0,0,0,0,0,0,0,4,12,31,50,54,43,41,37,21,7,6,5,4,1,0,0,0,0,0,0,0,6,9,10,12,14,10,5,2,0,0,0,0,0,0,0,0,0
0,0,0,0,0,0,0,0,0,0,0,0,0,0,0,0,0,0,0,0,0,0,0,0,0,0,0,0,0,0,0,0,0,0,0,0,0,0,0,2,4,5,6,6,6,14,16,8,0,0,0,0,0,0,0,0,0,0,0,0,0,0,3,10,26,34,36,41,64,64,41,14,10,8,7,6,3,1,0,0,0,0,0,5,9,10,11,13,9,6,4,1,0,0,0,0,0,0,0,0
0,0,0,0,0,0,0,0,0,0,0,0,0,0,0,0,0,0,0,0,0,0,0,0,0,0,0,0,0,0,0,0,0,0,0,0,0,0,0,0,1,3,4,5,6,11,12,6,0,0,0,0,0,0,0,0,0,0,0,0,0,0,1,9,21,32,39,43,57,54,35,16,12,7,6,7,7,10,9,5,3,3,1,5,9,11,13,14,8,5,5,2,0,0,0,0,0,0,0,0
0,0,0,0,0,0,0,0,0,0,0,0,0,0,0,0,0,0,0,0,0,0,0,0,0,0,0,0,0,0,0,0,0,0,0,0,0,0,0,0,0,0,0,1,2,6,8,5,0,0,0,0,0,0,0,0,0,0,0,0,0,0,0,5,14,29,39,37,27,28,30,22,18,17,12,10,12,19,20,15,10,10,7,8,10,12,13,15,7,4,5,3,0,0,0,0,0,0,0,0
0,0,0,0,0,0,0,0,0,0,0,0,0,0,0,0,0,0,0,0,0,0,0,0,0,3,5,3,0,0,0,0,0,0,0,0,0,0,0,0,0,0,0,0,0,10,17,10,0,0,0,0,0,0,0,0,0,0,0,3,7,8,6,6,11,25,41,46,36,42,49,46,34,32,26,19,17,20,22,20,19,20,16,15,13,11,12,14,7,2,4,4,1,0,0,0,0,0,0,0
0,0,0,0,0,0,0,0,0,0,0,0,0,0,0,0,0,0,0,0,0,0,0,0,0,5,11,10,2,0,0,0,0,0,0,0,0,0,0,0,0,0,0,0,1,16,22,14,0,0,0,0,0,0,0,0,0,0,0,5,11,13,9,7,10,35,66,72,51,48,49,45,34,35,31,25,21,16,17,21,24,25,24,24,19,13,12,14,7,1,4,5,3,0,0,0,0,0,0,0
0,0,0,0,0,0,0,0,0,0,0,0,0,0,0,0,0,0,0,0,0,0,0,0,0,3,12,13,6,0,0,0,0,0,0,0,0,0,0,0,0,0,1,3,5,13,17,9,0,0,0,0,0,0,0,0,0,0,0,3,7,8,6,5,7,43,85,94,55,32,28,25,20,20,20,18,15,13,14,16,19,23,26,32,27,18,13,14,7,1,3,5,4,0,0,0,0,0,0,0
0,0,0,0,0,0,0,0,0,0,0,0,0,0,0,0,0,0,0,0,0,0,0,0,0,0,6,11,10,2,0,0,0,0,0,0,0,0,0,1,3,5,6,6,6,6,4,2,0,0,0,0,0,0,0,0,0,0,0,0,0,0,0,0,3,30,71,68,36,11,8,6,6,8,8,6,4,7,9,8,8,13,23,32,30,21,18,17,8,1,1,4,4,2,0,0,0,0,0,0
0,0,0,0,0,0,0,0,0,0,0,0,0,0,0,0,0,0,0,0,0,0,0,0,0,0,2,7,9,7,3,0,0,0,2,4,4,10,19,18,12,9,8,6,3,1,0,0,0,0,0,0,0,0,0,0,0,0,0,0,0,0,0,0,0,13,35,37,15,2,3,3,3,1,0,0,0,4,6,4,1,5,15,28,32,24,21,20,11,2,0,3,5,3,0,0,0,0,0,0
0,0,0,0,0,0,0,0,0,0,0,0,0,0,0,0,0,0,0,0,0,0,0,0,0,0,0,2,6,8,10,12,11,8,7,7,7,18,29,27,14,7,4,1,0,0,0,0,0,0,0,0,0,0,0,0,0,0,0,0,0,0,0,0,0,11,23,20,6,0,0,0,0,0,0,0,0,4,7,4,0,0,8,24,32,27,22,21,13,7,6,10,11,5,0,0,0,0,0,0
0,0,0,0,0,0,0,0,0,0,0,0,0,0,0,0,0,0,0,0,0,0,0,0,0,0,0,0,1,4,12,18,18,12,8,5,4,10,19,16,6,0,0,0,0,0,0,0,0,0,0,0,0,0,0,0,0,0,0,0,0,0,0,0,0,9,26,27,10,0,0,0,0,0,0,0,0,3,6,4,0,0,4,17,29,30,26,21,15,11,11,14,13,7,0,0,0,0,0,0
0,0,0,0,0,0,0,0,0,0,0,0,0,0,0,0,0,0,0,0,0,0,0,0,0,0,0,0,0,0,5,11,11,7,3,0,0,0,0,0,0,0,0,0,0,0,0,0,0,0,0,0,0,0,0,0,0,0,0,0,0,0,0,0,0,5,29,39,21,0,0,0,0,0,0,0,0,1,4,4,1,0,3,12,24,35,35,24,13,11,10,9,8,3,0,0,0,0,0,0
0,0,0,0,0,0,0,0,0,0,0,0,0,0,0,0,0,0,0,0,0,0,0,0,0,0,0,0,0,0,0,0,0,0,0,0,0,0,0,0,0,0,0,0,0,0,0,0,0,0,0,0,0,0,0,0,0,0,0,0,0,0,0,0,0,1,38,58,35,0,0,0,0,0,0,0,0,0,2,3,2,0,4,10,20,35,39,25,9,6,5,3,0,0,0,0,0,0,0,0
0,0,0,0,0,0,0,0,0,0,0,0,0,0,0,0,0,0,0,0,0,0,0,0,0,0,0,0,0,0,0,0,0,0,0,0,0,0,0,0,0,0,0,0,0,0,0,0,0,0,0,0,0,0,0,0,0,0,0,0,0,0,0,0,0,0,36,56,36,0,0,0,0,0,0,0,0,0,2,4,3,2,5,9,15,29,37,26,8,2,4,5,2,0,0,0,0,0,0,0
0,0,0,0,0,0,0,0,0,0,0,0,0,0,0,0,0,0,0,0,0,0,0,0,0,0,0,0,0,0,0,0,0,0,0,0,0,0,0,0,0,0,0,0,0,0,0,0,0,0,0,0,0,0,0,0,0,0,0,0,0,0,0,0,0,0,24,40,24,0,0,0,0,0,0,0,0,0,2,5,6,3,4,6,10,23,36,29,11,1,2,5,4,0,0,0,0,0,0,0
0,0,0,0,0,0,0,0,0,0,0,0,0,0,0,0,0,0,0,0,0,0,0,0,0,0,0,0,0,0,0,0,0,0,0,0,0,0,0,0,0,0,0,0,0,0,0,0,0,0,0,0,0,0,0,0,0,0,0,0,0,0,0,0,0,0,20,32,20,0,0,0,0,0,0,0,0,0,1,6,6,3,1,4,8,21,35,31,12,1,1,4,4,2,0,0,0,0,0,0
0,0,0,0,0,0,0,0,0,0,0,0,0,0,0,0,0,0,0,0,0,0,0,0,0,0,0,0,0,0,0,0,0,0,0,0,0,0,0,0,0,0,0,0,0,0,0,0,0,0,0,0,0,0,0,0,0,0,0,0,0,0,0,0,0,0,18,27,18,0,0,6,15,16,12,10,8,7,7,10,16,17,10,6,7,18,32,31,15,6,5,9,17,22,14,4,0,0,0,0
0,0,0,0,0,0,0,0,0,0,0,0,0,0,0,0,0,0,0,0,0,0,0,0,0,0,0,0,0,0,0,0,0,0,0,0,0,0,0,0,0,0,0,0,0,0,0,0,0,0,0,0,0,0,0,0,0,0,0,0,0,0,0,0,0,0,7,12,7,0,0,11,24,27,19,16,13,11,9,15,26,29,19,11,9,18,35,50,40,19,8,12,25,32,24,6,0,0,0,0
0,0,0,0,0,0,0,0,0,0,0,0,0,0,0,0,0,0,0,0,0,0,0,0,0,0,0,0,0,0,0,0,0,0,0,0,0,0,0,0,0,0,0,0,0,0,0,0,0,0,0,0,0,0,0,0,0,0,0,0,0,0,0,0,0,0,0,0,0,0,0,6,15,16,12,10,8,7,5,11,20,24,17,13,15,21,39,60,50,23,5,7,14,20,14,4,0,0,0,0
0,0,0,0,0,0,0,0,0,0,0,0,0,0,0,0,0,0,0,0,0,0,0,0,0,0,0,0,0,0,0,0,0,0,0,0,0,0,0,0,0,0,0,0,0,0,0,0,0,0,0,0,0,0,0,0,0,0,0,0,0,0,0,0,0,0,0,0,0,0,0,0,0,0,0,0,0,0,0,2,6,7,7,12,16,20,33,44,35,10,0,0,0,0,0,0,0,0,0,0
0,0,0,0,0,0,0,0,0,0,0,0,0,0,0,0,0,0,0,0,0,0,0,0,0,0,0,0,0,0,0,0,0,0,0,0,0,0,0,0,0,0,0,0,0,0,0,0,0,0,0,0,0,0,0,0,0,0,0,0,0,0,0,0,0,0,0,0,0,0,0,0,0,0,0,0,0,0,0,0,0,1,4,7,10,11,17,16,7,0,0,0,0,0,0,0,0,0,0,0
