0,0,0,0,0,0,0,0,0,0,0,0,0,0,0,0,0,0,0,0,0,0,0,0,0,0,0,0,0,0,0,0,0,0,0,0,0,0,0,0,0,0,0,0,0,0,0,0,0,0,0,0,0,0,0,0,0,0,0,0,0,0,0,0,0,0,0,0,0,0,0,0,0,0,0,0,0,0,0,0,0,0,0,0,0,0,0,0,0,0,0,0,0,0,0,0,0,0,0,0
0,0,0,0,0,0,0,0,0,0,0,0,0,0,0,0,0,0,0,0,0,0,0,0,0,0,0,0,0,0,0,0,0,0,0,0,0,0,0,0,0,0,0,0,0,0,0,0,0,0,0,0,0,1,4,4,1,0,2,7,11,11,10,8,6,5,14,18,9,0,0,0,0,0,0,0,0,0,0,0,0,0,0,0,0,0,0,0,0,0,0,0,0,0,0,0,0,0,0,0
0,0,0,0,0,0,0,0,0,0,0,0,0,0,0,0,0,0,0,0,0,0,0,0,0,0,0,0,0,0,0,0,0,0,0,0,0,0,0,0,0,0,0,0,0,0,0,0,0,0,1,3,2,5,9,9,6,4,6,15,21,21,18,16,11,15,37,38,20,0,0,0,0,0,0,0,0,0,0,0,0,0,0,0,0,0,0,0,0,0,0,0,0,0,0,0,0,0,0,0
0,0,0,0,0,0,0,0,0,0,0,0,0,0,0,0,0,0,0,0,0,0,0,0,0,0,0,0,0,0,0,0,0,0,0,0,0,0,0,0,0,0,0,0,0,0,0,0,0,0,2,6,7,12,22,27,20,13,13,20,24,20,15,13,12,20,43,46,21,0,0,0,0,0,0,0,0,0,0,0,0,0,0,0,0,0,0,0,0,0,0,0,0,0,0,0,0,0,0,0
0,0,0,0,0,0,0,0,0,0,2,5,6,3,1,0,0,0,0,0,0,0,0,0,0,0,0,0,0,0,0,0,0,0,0,0,0,0,0,0,0,0,0,0,0,0,0,0,0,0,1,6,11,20,29,34,28,21,17,20,20,13,9,9,12,21,50,56,27,0,0,0,0,0,0,0,0,0,0,0,0,0,0,0,0,0,0,0,0,0,0,0,0,0,0,0,0,0,0,0
0,0,0,0,0,0,0,0,0,0,4,8,9,5,3,2,1,1,0,0,0,0,0,0,0,0,0,0,0,0,0,0,0,0,0,0,0,0,0,0,0,0,0,0,0,0,0,0,0,0,0,3,11,17,22,23,24,19,17,17,18,20,18,18,19,25,61,70,38,0,0,0,0,0,0,0,0,0,0,0,0,0,0,0,0,0,0,0,0,0,0,0,0,0,0,0,0,0,0,0
0,0,0,0,0,0,0,0,0,0,2,5,6,4,3,3,3,2,2,1,0,0,0,0,0,0,0,0,0,0,0,0,0,0,0,0,0,0,0,0,0,0,0,0,0,0,0,0,0,0,0,3,8,9,5,6,12,14,11,9,21,34,31,27,32,36,65,72,38,0,0,0,0,0,0,0,0,0,0,0,0,0,0,0,0,0,0,0,0,0,0,0,0,0,0,0,0,0,0,0
0,0,0,0,0,0,2,5,6,3,1,0,0,0,1,2,1,2,3,3,2,1,0,0,0,0,0,0,0,0,0,0,0,0,0,0,0,0,0,0,0,0,0,0,0,0,0,0,0,0,0,3,6,4,0,2,8,10,7,11,39,51,39,29,38,43,62,62,32,0,0,0,0,0,0,0,0,0,0,0,0,0,0,0,0,0,0,0,0,0,0,0,0,0,0,0,0,0,0,0
0,0,0,0,0,0,4,8,9,5,3,2,0,0,0,0,0,0,1,3,4,3,1,0,0,0,0,0,0,0,0,0,0,0,0,0,0,0,0,0,0,0,0,0,0,3,5,3,0,0,0,1,5,5,1,0,5,7,5,20,54,64,40,32,41,45,65,68,32,0,0,0,0,0,0,0,0,0,3,7,5,0,0,0,0,0,0,0,0,0,0,0,0,0,0,0,0,0,0,0
0,0,0,0,0,0,2,5,6,4,3,3,2,1,0,0,0,0,0,1,3,4,3,1,0,0,0,0,0,0,0,0,0,0,0,0,0,0,0,0,0,0,0,0,0,5,9,9,3,0,0,0,3,5,3,0,1,5,8,27,56,67,50,40,37,37,65,89,71,27,8,2,2,3,3,3,2,1,6,12,11,3,0,0,0,0,0,0,0,0,0,0,0,0,0,0,0,0,0,0
0,0,0,0,0,0,0,0,0,0,1,2,2,2,2,1,0,0,0,0,0,2,4,3,2,0,0,0,0,0,0,0,0,0,0,0,0,0,0,3,5,3,0,0,0,3,8,8,5,3,2,0,1,5,5,2,0,5,13,24,49,63,53,41,34,28,55,99,101,69,40,23,17,17,14,10,8,7,8,14,15,11,4,0,0,0,0,0,0,0,0,0,0,0,0,0,0,0,0,0
0,0,0,0,0,0,0,0,0,0,0,0,1,1,2,3,2,1,0,0,0,0,2,4,3,1,0,0,0,0,0,0,0,0,0,0,0,0,0,6,10,7,0,0,0,0,1,2,4,4,3,2,2,6,7,5,5,10,14,17,36,53,49,35,34,28,44,77,93,79,57,40,32,31,27,21,17,16,13,12,20,19,10,0,0,0,0,0,0,0,0,0,0,0,0,0,0,0,0,0
0,0,0,0,0,0,0,0,0,0,0,0,0,0,1,2,2,2,1,0,0,0,0,2,3,3,1,0,0,0,0,0,0,0,0,0,0,0,0,4,9,8,3,1,0,0,0,0,0,2,2,2,5,9,8,7,12,17,15,12,24,40,40,36,41,41,44,56,70,73,66,52,49,51,42,31,24,20,17,15,25,28,17,2,0,0,0,0,0,0,0,0,0,0,0,0,0,0,0,0
0,0,0,0,0,0,0,0,0,0,0,0,0,0,0,0,1,2,2,2,0,0,0,0,1,4,4,2,0,0,0,0,0,0,0,0,0,0,0,0,2,4,4,3,2,1,0,0,0,0,0,1,10,18,15,13,20,22,19,18,21,30,34,40,46,52,55,73,82,93,97,89,88,86,62,39,32,24,19,20,28,33,24,9,0,0,0,0,0,0,0,0,0,0,0,0,0,0,0,0
0,0,0,0,0,0,0,0,0,0,0,0,0,0,0,0,0,1,2,2,2,1,0,0,0,3,8,10,7,4,4,3,2,2,1,1,1,1,1,3,4,4,6,7,7,7,5,2,1,1,1,2,13,24,28,26,27,24,22,32,37,34,31,41,47,67,86,93,87,99,105,102,98,86,59,31,30,25,19,19,27,37,32,18,4,0,0,0,0,0,0,0,0,0,0,0,0,0,0,0
0,0,0,0,0,0,0,0,0,0,0,0,0,0,0,0,0,0,0,2,2,2,1,0,0,1,8,12,12,8,9,9,7,5,3,2,3,4,5,5,5,5,5,6,8,9,10,8,5,4,5,5,10,18,26,33,35,27,20,37,47,44,32,42,71,116,132,120,81,63,64,55,52,48,28,13,17,18,15,13,21,31,36,24,11,2,0,0,0,0,0,0,0,0,0,0,0,0,0,0
0,0,0,0,0,0,0,0,0,0,0,0,0,0,0,0,0,0,0,0,1,2,2,2,1,0,3,8,11,10,9,10,10,7,4,3,4,5,5,4,3,3,3,3,3,6,9,11,10,8,7,6,5,7,16,30,36,30,20,33,46,44,39,46,104,147,154,94,63,26,15,7,9,10,7,4,4,8,8,6,11,24,31,30,18,6,0,0,0,0,0,0,0,0,0,0,0,0,0,0
0,0,0,0,0,0,0,0,0,0,0,0,0,0,0,0,0,0,0,0,0,1,2,3,4,2,0,5,11,10,5,5,7,8,8,5,3,3,2,0,0,0,0,0,1,3,5,9,10,9,8,7,5,4,11,24,36,32,31,40,45,39,36,43,104,143,117,52,27,9,5,1,4,6,6,3,2,5,6,5,6,15,26,30,24,11,3,0,0,0,0,0,0,0,0,0,0,0,0,0
0,0,0,0,0,0,0,0,0,0,0,0,0,0,0,0,0,0,0,0,0,0,0,4,7,6,2,6,11,9,1,0,3,8,10,8,3,0,0,0,1,1,2,3,3,4,3,4,6,9,14,16,15,12,16,24,35,40,47,52,50,33,26,26,83,124,90,19,1,0,0,0,2,4,4,4,4,5,5,4,5,10,19,25,26,16,6,0,0,0,0,0,0,0,0,0,0,0,0,0
0,0,0,0,0,0,0,0,0,0,0,0,0,0,0,0,1,4,4,1,0,0,0,2,7,9,6,4,5,2,0,1,3,5,7,12,14,9,6,10,10,8,6,4,4,4,4,3,5,10,17,22,20,15,20,28,36,43,50,47,39,27,16,14,64,109,90,25,2,0,0,0,4,7,6,4,5,6,7,4,4,7,12,19,24,21,9,1,0,0,0,0,0,0,0,0,0,0,0,0
0,0,0,0,0,0,0,0,0,0,0,0,0,0,1,2,4,8,8,4,0,0,0,0,4,6,7,6,8,8,6,5,5,4,4,15,24,24,18,19,18,14,13,9,5,3,4,7,8,8,12,14,12,9,18,26,31,34,38,30,23,16,13,13,46,82,76,36,8,0,0,0,6,10,8,3,4,7,9,7,4,6,9,15,21,20,11,4,4,7,4,0,0,0,0,0,0,0,0,0
0,0,0,0,0,0,0,0,0,0,0,0,1,3,5,4,4,8,9,4,0,0,0,0,0,2,4,8,13,14,10,5,4,3,2,8,21,22,19,17,16,15,15,14,9,7,7,7,7,4,3,5,4,3,10,21,22,21,25,25,16,9,8,15,29,52,77,67,26,0,0,0,6,10,6,0,1,5,9,10,7,7,9,14,16,19,14,7,9,13,8,0,0,0,0,0,0,0,0,0
0,0,0,0,0,0,0,0,0,0,0,3,7,8,5,3,1,4,8,9,3,0,0,0,0,0,1,6,10,10,6,3,2,2,1,0,4,9,9,7,7,9,11,13,13,17,16,9,1,0,0,4,6,7,8,13,13,12,16,24,22,17,17,24,25,42,88,96,45,0,0,0,4,6,4,0,0,2,6,10,8,8,8,12,14,18,15,9,9,12,7,0,0,0,0,0,0,0,0,0
0,0,0,0,0,0,0,0,0,0,0,5,9,8,2,0,0,1,9,12,8,1,0,0,0,1,3,3,3,1,0,0,0,0,0,0,1,3,4,4,4,3,2,7,13,20,21,15,5,2,3,8,11,9,10,12,9,4,8,15,23,27,30,29,21,28,78,90,44,0,0,0,1,4,3,1,0,1,2,6,8,8,9,11,14,16,15,9,7,5,3,0,0,0,0,0,0,0,0,0
0,0,0,0,0,0,0,0,0,0,0,3,5,3,0,0,0,0,5,11,10,4,3,5,6,5,4,3,1,0,0,0,0,0,1,2,6,8,6,2,0,0,1,6,9,12,14,14,12,13,12,11,10,10,11,12,12,10,12,14,17,20,24,20,11,16,54,65,33,0,0,0,0,2,3,1,0,0,1,4,5,7,9,11,12,13,13,11,8,4,3,0,0,0,0,0,0,0,0,0
0,0,0,0,0,0,0,0,0,0,0,0,0,0,0,0,0,0,0,7,15,16,15,19,19,13,8,9,12,11,8,8,6,5,5,9,15,14,10,9,14,17,15,10,6,1,2,6,13,16,14,9,13,17,16,16,18,18,19,19,15,9,8,6,4,12,42,49,25,0,0,0,0,2,3,2,0,0,1,3,4,5,9,11,10,13,17,13,9,5,3,0,0,0,0,0,0,0,0,0
0,0,0,0,0,0,0,0,0,0,0,0,0,0,0,0,0,0,0,6,16,20,20,22,21,14,9,14,18,19,13,13,10,8,6,11,14,14,10,14,25,31,26,13,3,0,0,0,4,8,6,5,15,22,18,12,14,13,13,15,14,12,11,8,7,16,56,72,35,0,0,0,0,1,3,2,0,0,1,2,3,5,9,9,11,18,22,17,10,6,3,0,0,0,0,0,0,0,0,0
0,0,0,0,0,0,0,0,0,0,0,0,0,0,0,0,0,0,0,3,9,11,10,10,9,6,5,8,12,11,8,8,6,5,3,4,7,6,4,9,17,24,19,9,1,0,0,0,0,0,0,2,10,15,10,5,4,2,1,4,8,13,14,12,9,16,57,68,40,0,0,0,0,1,3,3,1,0,1,1,3,4,8,9,13,21,23,17,11,7,2,0,0,0,0,0,0,0,0,0
0,0,0,0,0,0,0,0,0,0,0,0,0,0,0,0,0,0,0,0,0,0,0,0,0,0,0,0,0,0,0,0,0,0,0,0,0,0,0,0,1,4,5,2,0,0,0,0,0,0,0,0,2,3,2,0,0,0,0,0,2,6,7,7,6,8,28,40,20,0,0,0,0,0,2,3,2,0,0,1,3,5,6,8,14,20,19,13,11,7,2,0,0,0,0,0,0,0,0,0
0,0,0,0,0,0,0,0,0,0,0,0,0,0,0,0,0,0,0,0,0,0,0,0,0,0,0,0,0,0,0,0,0,0,0,0,0,0,0,0,0,0,0,0,0,0,0,0,0,0,0,0,0,0,0,0,0,0,0,0,0,0,0,0,0,0,0,0,0,0,0,0,0,0,1,3,2,0,0,1,3,5,6,7,14,18,16,10,10,6,2,0,0,0,0,0,0,0,0,0
0,0,0,0,0,0,0,0,0,0,0,0,0,0,0,0,0,0,0,0,0,0,0,0,0,0,0,0,0,0,0,0,0,0,0,0,0,0,0,0,0,0,0,0,0,0,0,0,0,0,0,0,0,0,0,0,0,0,0,0,0,0,0,0,0,0,0,0,0,0,0,0,0,0,1,2,2,1,0,1,3,5,6,6,12,17,16,10,10,8,3,0,0,0,0,0,0,0,0,0
0,0,0,0,0,0,0,0,0,0,0,0,0,0,0,0,0,0,0,0,0,0,0,0,0,0,0,0,0,0,0,0,0,0,0,0,0,0,0,0,0,0,0,0,0,0,0,0,0,0,0,0,0,0,0,0,0,0,0,0,0,0,0,0,0,0,0,0,0,0,0,0,0,0,0,2,2,1,0,0,3,5,6,7,11,15,14,11,11,9,4,0,0,0,0,0,0,0,0,0
0,0,0,0,0,0,0,0,0,0,0,0,0,0,0,0,0,0,0,0,0,0,0,0,0,0,0,0,0,0,0,0,0,0,0,0,0,0,0,0,0,0,0,0,0,0,0,0,0,0,0,0,0,0,0,0,0,1,1,2,1,1,0,0,0,0,0,0,0,0,0,0,0,0,0,1,2,1,0,0,2,5,10,13,12,13,12,10,11,10,4,3,6,3,0,0,0,0,0,0
0,0,0,0,0,0,0,0,0,0,2,6,7,4,1,0,0,0,0,0,0,0,0,0,0,0,0,0,0,0,0,0,0,0,0,0,0,0,0,0,0,0,0,0,0,0,0,0,0,0,0,0,0,2,4,4,4,5,5,4,3,2,2,2,2,2,1,0,0,0,0,0,0,0,0,1,2,2,0,0,1,7,15,15,11,11,13,10,11,10,4,7,11,7,0,0,0,0,0,0
0,0,0,0,0,0,0,0,0,0,4,9,11,8,4,3,1,0,0,0,0,0,0,0,0,0,0,0,0,0,0,0,0,0,0,0,0,0,0,0,0,0,0,0,0,0,2,2,3,5,6,6,5,6,6,6,6,6,6,5,4,4,4,4,3,3,2,1,1,1,0,0,0,0,0,1,2,2,1,0,0,9,16,14,6,10,15,11,9,10,5,7,12,7,0,0,0,0,0,0
0,0,0,0,4,8,6,2,0,0,2,6,7,5,4,4,4,3,0,0,0,0,0,0,0,0,0,0,0,0,0,0,0,0,0,0,0,0,0,0,0,0,0,0,0,3,8,12,13,13,16,16,11,7,5,4,4,3,3,3,3,4,4,4,3,3,2,2,2,2,2,1,0,0,0,0,1,2,1,0,0,8,15,11,4,10,15,11,8,9,4,4,7,4,0,0,0,0,0,0
0,0,0,0,6,12,12,5,1,0,0,0,0,0,1,3,4,5,3,0,0,0,0,0,0,0,0,0,0,0,0,0,0,0,0,0,0,0,0,0,0,0,0,0,2,4,10,15,17,14,19,21,18,8,3,0,0,0,0,1,2,2,2,2,2,2,2,1,1,2,3,2,1,1,0,0,0,1,0,0,0,8,14,10,4,10,15,10,7,7,5,4,5,3,0,0,0,0,0,0
0,0,0,0,4,9,9,6,5,3,1,0,0,0,0,0,2,4,5,3,0,0,0,0,0,0,0,0,0,0,0,0,0,0,0,0,1,1,1,1,1,1,2,4,5,6,10,15,14,9,12,18,18,14,11,13,15,10,4,2,2,2,2,1,2,2,2,1,1,1,1,2,2,2,1,0,1,1,1,0,1,8,13,10,4,9,14,10,7,7,9,8,5,1,0,0,0,0,0,0
0,0,0,0,0,0,2,4,5,9,11,6,1,0,0,0,0,2,4,7,9,8,5,4,4,4,3,3,2,2,2,2,1,1,2,2,2,2,2,2,2,3,6,8,7,7,10,11,10,8,9,12,16,17,16,22,26,22,13,10,10,10,8,5,4,6,6,6,5,2,0,0,1,2,2,2,2,2,1,0,1,6,11,10,5,8,13,12,8,8,12,12,7,0,0,0,0,0,0,0
0,0,0,0,0,0,0,0,2,11,15,13,9,8,4,0,0,0,2,9,13,13,8,10,13,10,6,4,4,3,4,4,3,3,3,2,1,1,1,1,2,4,8,8,7,7,12,14,11,9,8,8,8,10,10,16,21,21,16,14,15,16,15,11,9,8,8,9,9,7,5,2,1,2,2,2,3,2,1,0,0,3,10,10,6,7,13,14,10,9,10,10,6,1,0,0,0,0,0,0
0,0,0,0,0,0,0,0,0,4,10,10,13,16,12,4,1,0,0,4,8,8,5,10,13,10,3,6,10,9,7,8,7,5,4,3,2,1,2,3,4,6,8,7,7,13,18,15,9,6,5,4,4,3,2,3,5,8,9,9,10,13,14,14,11,8,6,6,7,8,8,8,6,3,2,3,5,4,2,0,0,3,11,12,7,7,12,13,10,7,5,5,4,1,0,0,0,0,0,0
0,0,0,0,0,0,0,0,0,0,0,2,8,14,13,8,5,3,3,3,3,3,2,5,8,5,1,8,15,19,18,19,20,19,14,11,13,12,8,6,7,9,9,7,10,22,26,17,6,2,1,1,0,0,0,0,1,2,1,1,2,4,8,10,10,8,5,4,4,4,7,9,8,5,4,4,6,7,4,0,0,5,12,12,7,7,13,12,9,7,4,3,3,2,0,0,0,0,0,0
0,0,0,0,0,0,0,0,0,0,0,0,0,3,5,6,5,5,5,4,4,4,4,3,3,3,2,7,16,21,23,22,26,25,23,21,22,18,10,10,15,17,14,11,13,23,28,18,4,0,0,0,0,0,0,0,0,0,0,0,0,0,1,4,7,8,9,7,5,2,3,5,5,5,5,6,7,8,7,4,4,7,12,10,6,8,13,12,7,7,4,3,2,2,1,0,0,0,0,0
0,0,0,0,0,0,0,0,0,0,0,0,0,0,0,0,2,3,3,3,3,3,2,2,2,1,2,6,10,12,12,10,12,14,15,16,17,11,5,9,15,19,13,10,10,24,37,29,9,0,0,0,0,0,0,0,0,0,0,0,0,0,0,0,1,4,6,7,6,4,3,2,2,4,5,5,5,7,8,7,7,9,14,12,6,9,13,11,7,7,4,1,1,2,1,0,0,0,0,0
0,0,0,0,0,0,0,0,0,0,0,0,0,0,0,0,0,0,0,0,0,0,0,0,0,0,7,12,10,4,0,0,0,0,2,5,4,2,0,4,10,11,7,5,5,29,49,38,9,0,0,0,0,0,0,0,0,0,0,0,0,0,0,0,0,0,1,3,4,5,5,4,4,5,4,3,3,5,8,8,8,11,16,15,9,9,12,10,9,11,5,1,1,2,1,0,0,0,0,0
0,0,0,0,0,0,0,0,0,0,0,0,0,0,0,0,0,0,0,0,0,0,0,0,2,5,12,14,8,0,0,0,0,0,0,0,3,8,8,4,4,5,5,5,7,28,41,30,4,0,0,0,0,0,0,0,0,0,0,0,0,0,0,0,0,0,0,0,2,3,5,6,7,7,6,3,1,4,6,7,7,11,15,15,11,12,12,9,13,17,10,1,0,2,2,1,0,0,0,0
0,0,0,0,0,0,0,0,0,0,0,0,0,0,0,0,0,0,0,0,4,8,7,4,5,6,9,8,3,0,0,0,0,0,0,0,5,11,13,7,6,10,23,29,21,17,21,12,1,0,0,0,0,0,0,0,0,0,0,0,0,0,0,0,0,0,0,0,0,1,2,4,6,7,7,5,4,4,5,6,8,12,14,15,14,14,13,8,14,20,12,1,0,1,3,3,0,0,0,0
0,0,0,0,0,0,0,0,0,0,0,0,0,0,0,0,0,0,0,0,7,13,12,5,4,3,2,0,0,0,0,0,0,0,0,0,3,7,7,4,4,10,31,36,25,7,6,4,1,0,0,0,0,0,0,0,0,0,0,0,0,0,0,0,0,0,0,0,0,0,0,2,3,5,6,7,7,7,5,5,7,11,13,15,15,17,14,10,13,18,11,1,0,0,3,4,2,0,0,0
0,0,0,0,0,0,0,0,0,0,0,0,0,0,0,0,0,0,0,0,4,8,7,3,1,0,0,0,0,0,0,0,0,0,0,0,0,0,0,0,1,5,16,21,10,1,2,2,0,0,0,0,0,0,0,0,0,0,0,0,0,0,0,0,0,0,0,0,0,0,0,0,1,2,3,5,8,9,7,5,6,10,14,16,13,15,15,12,13,17,11,1,0,0,2,4,3,0,0,0
0,0,0,0,0,0,0,0,0,0,0,0,0,0,0,0,0,0,0,0,0,0,0,0,0,0,0,0,0,0,0,0,0,0,0,0,0,0,0,0,0,0,0,0,0,0,0,0,0,0,0,0,0,0,0,0,0,0,0,0,0,0,0,0,0,0,0,0,0,0,0,0,0,1,2,2,5,8,10,9,6,8,14,18,11,10,12,12,14,16,11,2,0,0,0,3,4,2,0,0
0,0,0,0,0,0,0,0,0,0,0,0,0,0,0,0,0,0,0,0,0,0,0,0,0,0,0,0,0,0,0,0,0,0,0,0,0,0,0,0,0,0,0,0,0,0,0,0,0,0,0,0,0,0,0,0,0,0,0,0,0,0,0,0,0,0,0,0,0,0,0,0,0,0,1,1,3,7,10,11,7,7,15,20,13,8,9,12,17,23,16,7,3,1,0,3,5,3,0,0
0,0,0,0,0,0,0,0,0,0,0,0,0,0,0,0,0,0,0,0,0,0,0,0,0,0,0,0,0,0,0,0,0,0,0,0,0,0,0,0,0,0,0,0,0,0,0,0,0,0,0,0,0,0,0,0,0,0,0,0,0,0,0,0,0,0,0,0,0,0,0,0,0,0,0,1,2,5,10,11,9,8,14,19,15,10,10,14,20,25,19,12,6,4,1,3,5,3,0,0
0,0,0,0,0,0,0,0,0,0,0,0,0,0,0,0,0,0,0,0,0,0,0,0,0,0,0,0,0,0,0,0,0,0,0,0,0,0,0,0,0,0,0,0,0,0,0,0,0,0,0,0,0,0,0,0,0,0,0,0,0,0,0,0,0,0,0,0,0,0,0,0,0,0,0,0,1,3,8,11,11,10,14,20,18,14,13,15,17,20,16,11,7,5,3,4,5,3,0,0
0,0,0,0,0,0,0,0,0,0,0,0,0,0,0,0,0,0,0,0,0,0,0,0,0,0,0,0,0,0,0,0,0,0,0,0,0,0,0,0,0,0,0,0,0,0,0,0,0,0,0,0,0,0,0,0,0,0,0,0,0,0,0,0,0,0,0,0,0,0,0,0,0,0,0,1,0,1,5,12,15,13,14,19,21,19,18,16,11,11,10,8,5,5,5,6,5,1,0,0
0,0,0,0,0,0,0,0,0,0,0,0,0,0,0,0,0,0,0,0,0,0,0,0,0,0,0,0,0,0,0,0,0,0,0,0,0,0,0,0,0,0,0,0,0,0,0,0,0,0,0,0,0,0,0,0,0,0,0,0,0,0,0,0,0,0,0,0,0,0,0,0,0,0,1,3,2,0,2,10,16,14,11,15,19,21,21,17,10,9,8,7,5,5,6,6,4,0,0,0
0,0,0,0,0,0,0,0,0,0,0,0,0,0,0,0,0,0,0,0,0,0,0,0,0,0,0,0,0,0,0,0,0,0,0,0,0,0,0,0,0,0,0,0,0,0,0,0,0,0,0,0,0,0,0,3,6,5,1,0,0,0,0,0,0,0,0,0,0,0,0,0,0,0,1,3,3,1,0,6,15,15,9,10,16,22,24,21,13,9,7,5,4,4,7,7,4,0,0,0
0,0,0,0,0,0,0,0,0,0,0,0,0,0,0,0,0,0,0,0,0,0,0,0,0,0,0,0,0,0,0,0,0,0,0,0,0,0,0,0,0,0,0,0,0,0,0,0,0,0,0,0,0,0,0,5,10,11,6,2,0,0,0,0,0,0,0,0,0,0,0,0,0,0,0,2,3,1,0,3,14,17,11,7,14,21,24,22,15,11,8,6,3,2,8,9,5,0,0,0
0,0,0,0,0,0,0,0,0,0,0,0,0,0,0,0,0,0,0,0,0,0,0,0,0,0,0,0,0,0,0,0,0,0,0,0,0,0,0,0,0,0,0,0,0,0,0,0,0,0,0,0,0,0,0,3,8,12,11,6,0,0,0,0,0,0,0,0,0,0,0,0,0,0,0,2,3,2,2,7,19,23,19,15,17,21,25,20,15,14,17,13,8,6,12,14,9,1,0,0
0,0,0,0,0,0,0,4,6,4,0,0,0,0,0,0,0,0,0,0,0,0,0,0,0,0,0,0,0,0,0,0,0,0,0,0,0,0,0,0,0,0,0,0,0,0,0,0,0,0,0,0,2,4,2,0,0,6,10,8,2,0,0,0,0,0,0,0,0,0,0,0,0,0,0,1,3,2,5,11,22,25,30,29,28,23,27,24,18,19,23,20,16,15,18,23,19,8,0,0
0,0,0,0,0,0,0,7,12,10,2,0,0,0,0,0,0,0,0,0,0,0,0,0,0,0,0,0,0,0,0,0,0,0,0,0,0,0,0,0,0,0,1,0,0,0,0,0,0,0,0,0,6,9,6,0,0,1,7,11,7,1,0,0,0,0,0,0,0,0,0,0,0,0,0,1,4,6,10,13,19,26,36,43,38,34,35,31,22,18,18,18,19,22,19,26,24,13,0,0
0,0,0,0,0,0,0,4,10,9,5,2,0,0,0,0,0,0,0,0,0,0,0,0,0,0,0,0,0,0,0,0,0,0,0,0,0,0,0,0,0,1,2,1,0,0,0,0,0,0,0,0,5,9,5,0,0,0,4,10,10,5,0,0,0,0,0,0,0,0,0,0,0,0,0,2,6,10,13,11,12,19,30,37,40,43,46,40,26,16,9,9,15,20,16,20,21,11,0,0
0,0,0,0,0,0,0,0,2,4,5,4,3,0,0,0,0,0,0,0,0,0,0,0,0,0,0,0,0,0,0,0,0,0,0,0,0,0,0,0,0,1,2,1,0,0,0,0,0,0,0,0,4,7,4,0,0,0,2,6,12,12,5,0,0,0,0,0,0,0,0,0,0,1,3,4,7,11,13,10,10,13,20,25,33,43,48,43,32,24,15,10,13,16,14,13,11,6,0,0
0,0,0,0,0,0,0,0,0,0,2,4,4,3,1,0,0,0,0,0,0,0,0,0,0,0,0,0,0,0,0,0,0,0,0,0,0,0,0,0,0,1,2,1,0,0,0,0,0,0,0,0,5,8,5,0,0,0,0,0,9,14,11,1,0,0,0,0,0,0,0,0,1,3,4,3,4,7,13,12,10,8,12,17,25,33,43,43,38,33,33,26,17,13,13,10,8,4,0,0
0,0,0,3,6,4,0,0,0,0,0,1,3,4,4,1,0,0,0,0,0,0,0,0,0,0,0,0,0,0,0,0,2,4,2,0,0,0,0,0,0,1,2,1,0,0,0,0,0,0,0,0,5,8,5,0,0,0,0,0,4,11,10,4,0,0,0,0,0,0,0,3,8,11,10,10,13,20,29,25,17,11,12,14,19,25,35,39,40,40,45,36,22,12,10,7,6,4,0,0
0,0,0,7,12,9,1,0,0,0,0,0,1,3,4,3,2,0,0,0,0,0,0,0,0,0,0,0,0,0,0,0,5,9,7,1,0,0,0,0,0,0,1,1,0,0,0,0,0,0,0,0,4,6,4,0,0,0,0,0,0,6,13,10,1,0,0,0,0,0,2,10,16,17,16,18,23,31,55,82,90,71,45,27,22,27,35,39,41,42,43,33,22,17,13,8,6,4,0,0
0,0,0,5,11,9,2,0,0,0,0,0,0,0,1,3,3,3,1,0,0,0,0,0,0,0,0,0,0,0,0,0,4,9,8,3,0,0,0,0,0,0,1,1,1,0,0,0,0,0,0,0,2,4,4,0,0,0,0,0,0,8,16,14,3,0,0,0,0,0,17,55,89,93,75,55,40,54,105,148,149,124,89,59,44,44,42,44,63,88,89,76,81,89,89,93,78,31,0,0
0,0,0,1,4,5,3,1,0,0,0,0,0,0,0,1,3,3,2,1,0,0,0,0,0,0,0,0,0,0,0,0,1,3,4,4,2,0,0,0,0,0,5,9,6,2,2,0,0,0,0,0,0,6,8,4,0,0,0,0,0,9,18,14,3,0,0,0,0,0,27,75,124,128,104,66,41,56,100,131,116,109,106,90,70,63,56,58,83,103,110,97,113,121,130,139,115,51,0,0
0,0,0,0,0,2,3,3,1,0,0,0,0,0,0,0,0,1,2,2,2,0,0,0,0,0,0,1,2,1,0,0,0,0,1,3,3,2,0,0,0,0,8,12,10,5,6,3,0,0,0,0,0,7,10,7,0,0,0,0,0,7,15,13,4,0,0,0,0,0,14,44,74,79,62,39,23,31,51,47,26,49,82,91,72,66,63,67,71,69,61,57,65,73,75,85,74,28,0,0
0,0,0,0,0,0,2,3,3,0,0,0,0,0,0,0,0,0,0,2,2,2,1,0,0,0,0,4,6,4,0,0,0,0,0,0,2,2,2,4,7,6,8,10,8,7,7,4,0,0,0,0,0,5,9,6,0,0,0,0,0,4,13,16,9,2,0,0,0,0,0,0,0,0,0,0,0,0,0,0,0,23,54,67,57,55,57,66,50,19,0,0,0,0,0,0,0,0,0,0
0,0,0,0,0,0,0,2,3,2,0,0,0,0,0,0,0,0,0,0,2,2,2,1,0,0,0,5,8,5,0,0,0,0,0,0,0,1,3,8,12,12,8,5,3,5,6,3,0,0,0,0,0,2,4,3,1,0,0,0,0,1,9,16,13,4,0,0,0,0,0,0,0,0,0,0,0,0,0,0,0,8,24,39,41,42,46,58,50,22,0,0,0,0,0,0,0,0,0,0
0,0,0,0,0,0,0,0,2,3,2,0,0,0,0,0,0,0,0,0,0,1,2,6,8,4,0,3,6,6,3,1,0,0,0,0,0,0,1,6,10,10,7,4,2,4,5,3,0,0,0,0,0,0,6,9,5,0,1,3,2,1,7,14,15,9,4,0,0,0,0,0,0,0,0,0,0,0,1,1,1,3,12,24,31,37,38,54,51,27,0,0,0,0,0,0,0,0,0,0
0,0,0,0,0,0,0,0,0,2,3,2,0,0,0,0,0,0,0,0,0,0,1,10,15,10,0,0,3,4,4,3,3,3,2,0,0,0,0,2,3,3,3,2,2,13,20,10,0,0,0,0,0,0,8,12,8,2,4,5,3,1,10,22,28,22,13,2,0,0,0,0,0,0,0,0,1,3,3,3,2,3,9,19,26,34,37,52,51,31,3,0,0,0,0,0,0,0,0,0
0,0,0,0,0,0,0,0,0,0,2,2,1,0,0,0,0,0,0,0,0,0,0,7,14,12,4,0,0,2,3,3,4,5,5,3,0,0,1,3,2,0,0,1,2,28,42,26,0,0,0,0,0,0,6,11,7,3,5,4,1,1,13,31,41,32,19,8,1,0,0,0,0,0,0,0,3,4,4,2,3,3,6,16,25,33,35,47,49,34,9,1,0,0,0,0,0,0,0,0
0,0,0,0,0,0,0,0,0,0,1,2,2,2,0,0,0,0,0,0,0,0,0,1,5,8,6,2,0,0,0,1,2,4,5,6,7,7,6,3,1,0,0,0,3,36,52,32,0,0,0,0,0,0,2,5,5,4,4,3,0,1,11,33,40,29,15,9,3,0,0,0,0,0,0,1,4,4,2,2,2,2,3,12,23,30,29,36,44,39,16,2,0,0,0,0,0,0,0,0
0,0,0,0,0,0,0,0,0,0,0,1,2,2,2,1,0,0,0,0,0,0,0,0,1,4,5,4,1,0,0,0,0,0,2,5,11,16,13,4,0,0,0,1,4,27,39,23,0,0,0,0,0,0,0,4,4,6,5,3,0,3,8,24,29,18,8,11,6,0,0,0,0,0,0,2,4,3,1,2,2,0,2,9,21,28,25,22,37,41,26,6,1,0,0,0,0,0,0,0
0,0,0,0,0,0,0,0,0,0,0,0,0,2,2,2,1,0,0,0,0,0,0,0,0,0,2,4,3,2,0,0,0,0,0,3,10,17,15,9,2,1,2,4,4,16,22,13,0,0,0,0,0,0,0,2,3,6,5,3,0,4,10,19,21,13,13,18,11,0,0,0,0,0,0,3,4,3,2,2,1,0,2,7,20,27,21,13,29,41,33,13,4,0,0,0,0,0,0,0
0,0,0,0,0,0,0,0,0,0,0,0,0,0,1,2,2,1,0,0,0,0,0,0,0,0,0,2,6,9,7,2,0,0,0,2,6,12,13,11,8,11,14,10,2,14,22,13,0,0,0,0,0,0,0,0,2,5,6,2,0,5,10,12,13,13,26,30,18,0,0,0,0,0,0,3,4,4,3,2,0,0,2,7,18,25,21,12,24,39,36,17,6,1,0,0,0,0,0,0
0,0,0,0,0,0,0,0,0,0,0,0,0,0,0,1,2,2,1,0,0,0,0,0,0,0,0,0,5,12,13,7,1,0,0,1,6,10,12,12,11,16,18,15,6,25,35,21,0,0,0,0,0,0,0,0,1,4,6,3,0,6,10,8,7,13,35,42,23,0,0,0,0,0,2,4,4,2,3,1,0,0,2,6,15,23,22,16,23,36,35,20,8,2,0,0,0,0,0,0
0,0,0,0,0,0,0,0,0,0,0,0,0,0,0,0,1,3,6,8,6,1,0,0,0,0,0,0,2,8,11,10,6,2,1,2,7,11,11,12,14,14,14,12,9,40,56,33,0,0,0,0,0,0,0,0,0,3,6,5,2,6,12,10,6,12,56,77,42,0,0,0,0,0,3,5,4,2,2,1,0,0,2,6,13,21,23,18,21,31,32,24,12,4,0,0,0,0,0,0
0,0,0,0,0,0,0,0,0,0,0,0,0,0,0,0,0,1,10,18,17,10,5,2,0,0,0,0,0,0,3,7,7,5,3,4,10,11,8,13,18,17,12,10,8,47,67,41,0,0,0,0,0,0,0,0,0,2,6,7,5,6,14,15,12,13,66,85,52,0,0,0,0,0,3,5,5,3,2,0,0,0,2,6,13,20,23,18,20,27,30,27,18,6,0,0,0,0,0,0
0,0,0,0,0,0,0,0,0,0,0,0,0,0,0,0,0,0,8,16,17,13,10,7,4,1,0,0,0,0,0,2,5,5,4,5,10,11,8,15,26,28,17,14,13,56,78,45,0,0,0,0,0,0,0,1,2,4,7,9,8,7,13,20,20,18,49,66,38,5,4,4,4,3,5,6,8,7,4,1,1,1,3,8,16,25,24,20,24,29,31,30,21,6,0,0,0,0,0,0
0,0,0,0,0,0,0,0,0,0,0,0,0,0,0,0,0,0,2,5,6,7,8,8,7,7,8,6,3,1,0,0,0,3,5,6,9,11,9,17,27,28,20,16,21,63,75,42,0,0,0,0,0,1,4,4,4,5,7,11,13,13,15,20,23,24,32,32,22,13,12,10,10,9,11,10,10,8,6,2,2,2,2,8,18,26,24,22,30,33,34,31,24,7,1,0,0,0,0,0
0,0,0,0,0,0,0,0,0,0,0,0,0,0,0,0,0,0,0,0,0,0,1,4,5,10,13,13,6,3,1,0,0,3,5,8,8,7,12,22,29,24,20,18,25,55,66,34,0,0,0,2,6,8,7,8,6,6,6,11,17,19,17,18,21,29,39,37,28,24,23,21,20,19,17,15,13,11,7,2,3,3,3,7,18,29,27,22,29,33,33,34,32,16,5,4,5,2,0,0
0,0,0,0,0,0,0,0,0,0,0,0,0,0,0,0,0,0,0,0,0,0,0,0,1,5,13,17,15,9,7,5,7,12,12,11,15,19,24,27,27,21,26,23,23,38,49,36,13,9,8,11,13,12,9,11,14,15,13,18,27,30,22,14,15,29,41,39,29,25,24,25,25,24,23,23,23,18,10,3,2,3,3,6,17,29,27,23,25,30,28,36,41,31,16,16,15,7,0,0
0,0,0,0,0,0,0,0,0,0,0,0,0,0,0,0,0,0,0,0,0,0,0,0,0,0,7,14,16,12,10,8,18,26,25,17,20,25,27,24,19,18,23,24,21,28,41,37,24,16,15,15,16,13,12,17,21,21,18,21,28,31,26,24,24,32,41,40,29,24,26,28,29,28,30,36,41,41,32,18,11,8,5,7,15,23,24,23,26,29,25,34,43,36,25,33,31,12,0,0
0,0,0,0,0,0,0,0,0,0,0,0,0,0,0,0,0,0,0,0,0,0,0,0,0,0,3,8,9,8,8,8,17,25,24,16,17,18,16,11,9,17,19,17,17,27,35,33,21,14,16,17,16,14,14,15,16,15,13,15,18,21,25,34,41,37,38,41,37,31,31,32,32,32,36,42,50,56,56,45,35,27,20,15,18,20,17,20,26,28,23,29,34,28,23,44,46,20,0,0
0,0,0,0,0,0,0,0,0,0,0,0,0,0,0,0,0,0,0,0,0,0,0,0,0,0,0,0,0,1,3,5,8,10,9,8,8,8,6,5,8,18,24,24,24,32,34,28,20,15,16,17,19,14,12,9,8,6,7,6,5,5,12,32,42,40,42,52,54,48,43,36,31,29,30,31,36,45,53,56,56,49,39,32,32,31,27,24,24,26,21,25,27,20,19,46,48,22,0,0
0,0,0,0,0,0,0,2,4,2,0,0,0,0,0,0,0,0,0,0,0,0,0,0,0,0,0,0,0,0,1,4,5,4,1,2,6,10,8,7,10,19,25,28,28,29,33,40,40,30,23,20,17,12,7,5,8,10,10,11,13,11,10,23,34,35,39,50,50,41,32,23,19,17,16,14,14,18,27,38,48,50,46,44,47,49,43,38,34,31,22,24,29,24,21,38,39,16,0,0
0,0,0,0,0,0,0,4,8,7,3,2,0,0,0,0,0,0,0,0,0,0,0,0,0,0,0,0,0,0,0,4,9,11,7,5,6,8,8,9,10,12,15,19,21,20,31,46,46,30,22,18,15,12,9,9,12,12,11,15,19,20,20,26,35,38,39,35,28,18,13,9,7,7,5,4,3,5,9,15,25,36,43,49,57,59,52,45,46,42,29,29,35,30,23,32,28,11,0,0
0,0,0,0,0,0,0,2,6,7,5,3,4,5,6,4,3,2,0,0,0,0,0,0,0,3,8,9,6,5,4,7,12,14,11,9,7,7,7,10,10,9,7,11,15,20,31,38,30,15,12,13,12,11,8,8,9,8,7,11,18,25,26,25,37,48,44,26,10,0,0,0,2,3,2,1,1,3,7,7,13,26,35,42,56,58,48,43,47,43,33,39,46,45,36,35,27,12,0,0
0,0,0,0,0,0,0,0,1,2,3,2,5,9,10,7,5,4,3,2,1,0,0,0,1,8,15,16,11,9,8,10,14,15,12,8,7,9,13,13,9,11,12,17,21,28,29,21,7,1,3,4,6,5,4,5,6,3,6,14,22,31,35,29,43,60,58,31,12,0,0,0,0,0,0,0,5,11,12,9,12,20,28,34,47,52,47,51,54,42,35,48,62,64,54,51,38,18,0,0
0,0,0,0,0,0,0,0,0,0,0,0,2,5,6,4,4,3,3,3,4,6,9,7,5,8,12,11,7,6,7,8,13,13,10,8,8,13,18,19,19,21,19,19,24,32,27,12,0,0,0,0,0,0,0,3,5,3,8,18,27,44,56,47,44,59,63,39,14,0,0,0,0,0,0,0,8,18,23,16,16,18,23,31,43,49,52,68,67,46,32,49,62,64,59,62,53,25,0,0
0,0,0,0,0,0,0,0,0,0,0,0,0,0,0,0,0,1,1,2,4,10,13,12,7,4,2,1,0,0,1,3,8,10,9,6,11,21,29,32,30,25,19,14,19,29,25,11,0,0,0,0,0,0,0,8,14,10,5,12,19,42,59,51,33,41,60,54,22,0,0,0,0,0,0,1,8,21,27,23,17,14,21,36,50,54,55,71,69,47,31,39,43,42,44,54,47,20,0,0
0,0,0,0,0,0,0,0,0,0,0,0,0,0,0,0,0,0,0,0,1,6,9,7,3,1,0,0,0,0,0,0,3,6,5,3,13,25,36,39,37,23,11,8,14,25,25,10,0,0,0,0,0,3,9,20,21,13,2,1,7,27,42,33,15,18,54,64,34,0,0,0,0,0,1,6,12,18,23,22,16,11,19,41,59,56,52,59,54,39,34,36,27,22,27,36,29,10,0,0
0,0,0,0,0,0,0,0,0,0,0,0,0,0,0,0,0,0,0,0,0,0,0,0,0,0,0,0,0,0,0,0,3,5,4,0,9,17,26,30,27,14,4,3,10,28,33,16,0,0,0,0,0,5,19,27,22,8,1,0,8,24,30,20,8,5,39,58,35,0,0,0,0,0,4,14,20,16,13,14,11,9,19,43,57,52,44,46,43,35,36,35,22,11,18,24,19,6,0,0
0,0,0,0,0,0,0,0,0,0,0,0,0,2,5,5,3,3,3,2,1,1,1,1,2,3,2,3,4,6,15,21,14,10,13,11,10,11,14,20,24,14,6,4,8,43,61,35,0,0,0,0,0,5,29,45,32,16,22,28,39,51,47,25,11,7,50,79,46,0,4,18,27,23,25,44,57,52,43,52,58,46,33,41,50,46,44,50,70,92,101,81,58,44,46,69,71,32,0,0
0,0,0,0,0,0,0,0,0,0,0,0,0,4,8,8,5,4,4,4,3,2,2,3,4,4,4,5,6,10,26,31,21,11,16,16,11,10,13,17,17,13,8,5,5,42,59,37,0,0,0,0,0,3,27,43,37,25,34,45,53,58,45,24,12,10,58,77,51,0,8,29,42,38,35,54,69,70,61,77,92,80,48,40,51,52,70,98,119,129,127,103,74,64,61,94,90,50,0,0
0,0,0,0,0,0,0,0,0,0,0,0,0,2,5,5,3,3,3,2,1,1,1,1,2,3,2,3,4,6,15,21,12,5,9,9,7,6,7,9,9,7,4,3,3,19,30,16,0,0,0,0,0,1,13,24,19,14,22,28,31,30,21,10,7,6,30,46,25,0,4,18,27,23,20,29,40,41,38,49,74,74,51,43,56,64,95,121,113,87,76,59,44,38,36,53,56,27,0,0
0,0,0,0,0,0,0,0,0,0,0,0,0,0,0,0,0,0,0,0,0,0,0,0,0,0,0,0,0,0,0,0,0,0,0,0,0,0,0,0,0,0,0,0,0,0,0,0,0,0,0,0,0,0,0,0,0,0,0,0,0,0,0,0,0,0,0,0,0,0,0,0,0,0,0,0,0,0,0,2,23,42,37,34,47,58,80,90,56,10,0,0,0,0,0,0,0,0,0,0
0,0,0,0,0,0,0,0,0,0,0,0,0,0,0,0,0,0,0,0,0,0,0,0,0,0,0,0,0,0,0,0,0,0,0,0,0,0,0,0,0,0,0,0,0,0,0,0,0,0,0,0,0,0,0,0,0,0,0,0,0,0,0,0,0,0,0,0,0,0,0,0,0,0,0,0,0,0,0,0,11,22,21,17,23,30,35,31,13,0,0,0,0,0,0,0,0,0,0,0
