0,0,0,0,0,0,0,0,0,0,0,0,0,0,0,0,0,0,0,0,0,0,0,0,0,0,0,0,0,0,0,0,0,0,0,0,0,0,0,0,0,0,0,0,0,0,0,0,0,0,0,0,0,0,0,0,0,0,0,0,0,0,0,0,0,0,0,0,0,0,0,0,0,0,0,0,0,0,0,0,0,0,0,0,0,0,0,0,0,0,0,0,0,0,0,0,0,0,0,0
0,0,0,0,0,0,0,0,0,0,0,0,0,0,0,0,0,0,0,0,0,0,0,0,0,0,0,0,0,0,0,0,0,0,0,0,0,0,0,0,0,0,0,0,0,0,0,0,0,0,0,0,0,0,0,0,0,0,3,7,6,5,6,7,8,10,35,50,26,0,0,0,0,0,0,0,0,0,0,0,0,0,0,0,0,0,0,0,0,0,0,0,0,0,0,0,0,0,0,0
0,0,0,0,0,0,0,0,0,0,0,0,0,0,0,0,0,0,0,0,0,0,0,0,0,0,0,0,0,0,0,0,0,0,0,0,0,0,0,0,0,0,0,0,0,0,0,0,0,0,0,0,0,0,0,0,0,0,8,13,13,10,12,17,19,22,74,94,58,0,0,0,0,0,0,0,0,0,0,0,0,0,0,0,0,0,0,0,0,0,0,0,0,0,0,0,0,0,0,0
0,0,0,0,0,0,0,0,0,0,0,0,0,0,0,0,0,0,0,0,0,0,0,0,0,0,0,0,0,0,0,0,0,0,0,0,0,0,0,0,0,0,0,0,0,0,0,0,0,0,0,0,0,0,0,0,0,1,8,13,16,17,18,17,19,21,75,103,58,0,0,0,0,0,0,0,0,0,0,0,0,0,0,0,0,0,0,0,0,0,0,0,0,0,0,0,0,0,0,0
0,0,0,0,0,0,0,0,0,0,0,1,0,0,0,0,0,0,0,0,0,0,0,0,0,0,0,0,0,0,0,0,0,0,0,0,0,0,0,0,0,0,0,0,0,0,0,0,0,0,0,0,0,0,0,0,0,1,8,13,20,20,18,10,11,18,67,85,46,0,0,0,0,0,0,0,0,0,0,0,0,0,0,0,0,0,0,0,0,0,0,0,0,0,0,0,0,0,0,0
0,0,0,0,0,0,0,0,0,0,1,4,6,4,3,2,2,2,1,1,0,0,0,0,0,0,0,0,0,0,0,0,0,0,0,0,0,0,0,0,0,0,0,0,0,0,0,0,0,0,0,0,0,0,0,0,0,1,10,17,22,22,16,8,12,29,80,92,48,0,0,0,0,0,0,0,0,0,0,0,0,0,0,0,0,0,0,0,0,0,0,0,0,0,0,0,0,0,0,0
0,0,0,0,0,0,0,0,0,0,0,5,8,7,4,4,3,3,3,2,1,1,0,0,0,0,0,0,0,0,0,0,0,0,0,0,0,0,0,0,0,0,0,0,0,0,0,0,0,0,0,0,0,0,0,0,0,2,8,15,20,20,12,9,25,53,110,116,56,0,0,0,0,0,0,0,0,0,0,0,0,0,0,0,0,0,0,0,0,0,0,0,0,0,0,0,0,0,0,0
0,0,0,0,0,0,0,1,1,0,0,2,5,4,3,2,2,2,1,1,2,1,1,2,1,0,0,0,0,0,0,0,0,0,0,0,0,0,0,0,0,0,0,0,0,0,0,0,0,0,0,0,0,0,0,0,0,5,8,9,17,20,14,16,38,72,137,141,69,0,0,0,0,0,0,0,0,0,0,0,0,0,0,0,0,0,0,0,0,0,0,0,0,0,0,0,0,0,0,0
0,0,0,0,0,0,0,4,7,4,0,0,0,0,0,0,0,0,0,0,1,1,1,2,2,1,1,0,0,0,0,0,0,0,0,0,0,0,0,0,0,0,0,0,0,0,3,5,2,0,0,0,0,0,0,0,2,8,10,9,15,20,16,25,47,79,142,147,71,0,0,0,0,0,0,0,1,1,1,0,0,0,0,0,0,0,0,0,0,0,0,0,0,0,0,0,0,0,0,0
0,0,0,0,0,0,0,5,9,8,3,1,0,0,0,0,0,0,0,0,0,0,0,1,1,2,2,1,0,0,0,0,0,0,0,0,0,0,0,0,0,0,0,0,0,1,6,9,6,0,0,0,0,0,0,0,5,10,12,8,13,18,21,31,54,81,124,116,55,0,0,0,1,1,1,1,2,2,2,1,1,0,0,0,0,0,0,0,0,0,0,0,0,0,0,0,0,0,0,0
0,0,0,0,0,0,0,2,5,5,3,3,2,1,0,0,0,0,0,0,0,0,0,0,0,1,1,2,2,0,0,0,0,0,0,0,0,0,0,0,1,0,0,0,0,0,5,8,6,2,0,0,0,0,0,1,6,10,12,11,16,21,26,34,61,87,106,83,44,16,9,2,2,2,2,2,1,1,2,6,8,5,1,0,0,0,0,0,0,0,0,0,0,0,0,0,0,0,0,0
0,0,0,0,0,0,0,0,0,0,1,2,3,2,1,1,0,0,0,0,0,0,0,0,0,0,0,2,3,2,0,0,0,0,0,0,0,0,0,3,7,6,1,0,0,0,0,2,4,4,3,1,1,1,1,1,4,10,15,18,19,24,34,45,62,79,80,58,47,44,35,15,9,5,3,2,0,0,1,8,13,11,4,2,0,0,0,0,0,0,0,0,0,0,0,0,0,0,0,0
0,0,0,0,0,0,0,0,0,0,0,0,1,2,2,2,1,1,0,0,0,0,0,0,0,0,0,0,2,3,2,0,0,0,0,0,0,0,0,4,9,9,5,2,1,0,0,0,1,3,4,4,5,4,2,1,2,7,16,22,18,23,38,50,55,55,53,48,63,73,63,43,28,16,7,4,0,1,1,5,10,10,6,2,1,1,0,0,0,0,0,0,0,0,0,0,0,0,0,0
0,0,0,0,0,0,0,0,0,0,0,0,0,0,1,1,2,2,1,1,0,0,0,0,0,0,0,0,0,3,4,2,0,0,0,0,0,0,0,2,5,6,4,4,3,2,2,1,2,3,5,6,7,7,4,2,2,6,15,22,18,20,38,44,39,36,40,49,71,89,97,84,59,29,17,10,6,5,5,4,5,8,8,4,2,2,1,0,0,0,0,0,0,0,0,0,0,0,0,0
0,0,0,0,0,0,0,0,0,0,0,0,0,0,0,0,1,1,2,2,1,1,1,0,0,0,0,0,0,2,4,4,2,2,2,2,2,2,1,1,1,2,3,4,5,6,7,9,9,7,6,5,6,9,12,9,6,10,22,27,21,20,28,28,24,31,50,78,102,108,116,118,98,61,41,31,24,18,13,10,9,12,14,9,3,1,1,1,1,1,1,1,0,0,0,0,0,0,0,0
0,0,0,0,0,0,0,0,0,0,0,0,0,0,0,0,0,0,1,1,2,2,2,1,1,0,0,0,0,2,6,8,5,3,3,3,3,2,2,2,2,2,2,2,4,6,9,12,11,9,5,3,3,10,15,15,10,16,27,31,22,17,18,17,23,61,106,116,100,88,88,100,94,71,50,40,33,26,19,13,11,15,21,17,6,0,0,0,0,0,1,2,1,0,0,0,0,0,0,0
0,0,0,0,0,0,0,0,0,0,0,0,0,0,0,0,0,0,0,0,1,1,1,2,2,1,1,4,7,8,9,11,9,4,3,2,1,1,1,1,1,2,3,3,4,5,7,9,8,6,4,4,4,8,12,11,9,17,25,26,23,17,12,15,41,110,145,119,62,37,31,42,53,47,34,25,24,20,14,9,10,13,23,23,11,0,0,0,0,0,1,2,1,0,0,0,0,0,0,0
0,0,0,0,0,0,0,0,0,0,0,0,0,0,0,0,0,0,0,0,0,0,1,2,2,3,3,9,13,11,8,8,7,7,7,6,3,2,1,1,1,2,2,3,4,4,4,3,3,3,5,6,7,8,8,6,7,12,16,22,28,24,17,20,73,144,145,71,15,2,2,7,14,17,12,7,8,8,6,5,7,12,26,31,19,3,0,0,0,0,0,1,1,1,0,0,0,0,0,0
0,0,0,0,0,0,0,0,0,0,0,0,0,0,0,0,0,0,1,2,1,1,1,1,1,2,3,7,10,8,3,3,4,8,10,9,6,4,3,2,2,3,4,4,3,2,2,3,4,4,4,5,6,7,8,9,10,11,13,26,35,29,20,20,102,160,123,31,10,1,2,6,10,11,8,4,2,2,2,3,5,11,26,34,25,7,0,0,0,0,0,0,1,1,0,0,0,0,0,0
0,0,0,0,0,0,0,0,0,0,0,0,0,0,0,0,1,2,3,2,1,0,1,1,0,1,1,1,2,2,1,1,0,3,6,6,4,4,6,12,14,11,9,7,4,3,2,2,3,2,2,2,3,3,6,11,13,14,18,30,34,25,16,18,102,152,108,16,4,0,2,8,10,8,4,2,0,0,0,1,1,9,20,33,27,11,0,0,0,0,0,0,0,1,0,0,0,0,0,0
0,0,0,0,0,0,0,0,0,0,0,0,0,0,1,3,3,3,2,1,0,0,0,0,0,0,0,0,0,1,2,2,2,1,0,0,0,1,6,16,20,16,10,8,7,7,7,7,5,4,1,0,0,0,3,8,12,18,23,31,29,20,12,16,76,118,89,26,8,0,1,10,14,10,3,2,1,0,0,0,1,6,13,23,23,13,1,2,5,4,0,0,0,1,1,0,0,0,0,0
0,0,0,0,0,0,0,0,0,0,0,0,3,6,6,3,3,1,0,0,0,0,0,0,0,0,0,0,0,0,1,2,4,4,2,0,0,0,3,9,13,10,7,6,6,8,10,10,9,7,5,2,1,1,4,7,8,15,21,25,23,18,13,20,51,85,91,55,19,0,1,7,13,10,4,2,1,0,0,0,1,3,9,18,22,14,4,6,10,8,1,0,0,1,1,0,0,0,0,0
0,0,0,0,0,0,0,0,0,0,0,0,6,9,8,2,0,0,0,0,0,0,0,0,0,0,0,0,0,0,0,1,3,6,5,1,0,0,0,1,4,4,3,2,3,5,7,8,9,10,9,8,7,6,6,8,8,9,14,17,17,17,17,20,36,70,93,73,27,0,0,3,8,8,3,2,2,1,0,0,1,2,8,15,22,17,7,6,10,7,0,0,0,0,1,1,0,0,0,0
0,0,0,0,0,0,0,0,0,0,0,1,5,7,3,0,0,0,0,0,0,0,0,0,2,3,3,4,3,1,0,0,1,4,5,4,3,4,4,5,6,4,2,1,1,1,2,2,4,6,10,13,10,7,8,8,7,6,10,12,13,20,28,25,25,49,87,79,33,0,0,2,6,6,3,1,3,2,0,0,0,1,7,15,21,18,8,5,6,4,0,0,0,0,1,1,1,0,0,0
0,0,0,0,0,0,0,0,0,0,0,0,1,0,0,0,0,0,0,0,0,1,3,4,4,4,5,6,6,4,1,0,0,1,4,6,8,7,6,5,4,1,0,0,0,0,0,0,0,1,7,10,9,6,6,5,3,3,8,13,16,28,38,28,20,32,74,77,40,0,0,1,5,6,2,0,2,2,1,0,0,1,6,12,16,16,10,6,5,3,0,0,0,0,1,2,1,0,0,0
0,0,0,0,0,0,0,0,0,0,0,0,0,0,0,0,0,0,0,0,5,10,9,6,4,3,3,4,4,7,11,10,5,2,3,6,11,13,10,6,4,1,0,1,2,3,3,1,0,0,4,7,10,11,9,4,2,1,9,19,23,29,34,25,13,27,72,79,39,0,0,1,4,4,1,0,1,3,1,0,0,1,5,9,12,15,12,8,4,2,0,0,0,0,0,1,2,1,0,0
0,0,0,0,0,0,0,0,0,0,0,0,0,0,0,0,0,0,0,1,8,13,11,4,1,0,0,0,0,7,15,16,8,4,3,3,9,12,11,7,6,4,4,4,9,14,13,7,3,3,3,5,10,12,9,4,3,2,8,22,28,27,21,17,14,33,97,120,59,0,0,1,4,5,2,0,1,3,2,0,0,1,4,9,14,22,18,9,3,1,0,0,0,0,0,1,2,1,0,0
0,0,0,0,0,0,0,0,0,0,0,0,0,0,0,0,0,0,0,0,5,8,4,0,0,0,0,0,0,3,9,9,5,2,1,0,4,7,6,4,4,4,4,5,11,18,17,9,4,4,3,3,5,6,4,2,1,1,4,16,22,18,11,12,14,28,101,119,69,0,0,0,4,5,3,0,0,2,3,1,0,0,2,8,19,27,21,9,3,1,0,0,0,0,0,1,2,1,0,0
0,0,0,0,0,0,0,0,0,0,0,0,0,0,0,0,0,0,0,0,0,0,0,0,0,0,0,0,0,0,0,0,0,0,0,0,0,0,0,0,0,1,2,3,5,9,9,4,2,2,0,0,0,0,0,0,0,0,0,4,8,6,3,5,8,12,47,66,34,0,0,0,2,4,3,0,0,2,3,2,0,0,1,7,19,26,18,8,4,2,0,0,0,0,0,1,1,1,0,0
0,0,0,0,0,0,0,0,0,0,0,0,0,0,0,0,0,0,0,0,0,0,0,0,0,0,0,0,0,0,0,0,0,0,0,0,0,0,0,0,0,0,0,0,0,0,0,0,0,0,0,0,0,0,0,0,0,0,0,0,0,0,0,0,0,0,0,0,0,0,0,0,1,3,3,1,0,1,3,1,0,0,1,6,16,19,14,8,5,1,0,0,0,0,0,0,1,0,0,0
0,0,0,0,0,0,0,0,0,0,0,0,0,0,0,0,0,0,0,0,0,0,0,0,0,0,0,0,0,0,0,0,0,0,0,0,0,0,0,0,0,0,0,0,0,0,0,0,0,0,0,0,0,0,0,0,0,0,0,0,0,0,0,0,0,0,0,0,0,0,0,0,1,4,4,2,0,1,2,2,0,0,1,6,15,17,13,9,6,1,0,0,0,0,0,1,1,1,0,0
0,0,0,0,0,0,0,0,0,0,0,0,0,0,0,0,0,0,0,0,0,0,0,0,0,0,0,0,0,0,0,0,0,0,0,0,0,0,0,0,0,0,0,0,0,0,0,0,0,0,0,0,0,0,1,3,3,3,3,3,3,4,3,2,1,1,1,1,1,1,1,0,1,4,5,2,0,0,2,3,1,0,1,6,15,16,13,9,6,1,0,0,0,0,0,1,3,1,0,0
0,0,0,0,0,0,0,0,0,0,0,0,0,0,0,0,0,0,0,0,0,0,0,0,0,0,0,0,0,0,0,0,0,0,0,0,0,0,0,0,0,0,0,0,0,0,0,0,0,0,0,0,0,1,4,6,5,4,4,4,6,6,6,4,4,4,3,2,2,3,2,2,2,4,4,2,0,0,2,3,2,0,1,6,14,14,11,9,7,1,0,2,4,2,0,2,3,2,0,0
0,0,0,0,0,0,0,0,0,0,0,3,5,2,0,0,0,0,0,0,0,0,0,0,0,0,0,0,0,0,0,0,0,0,0,0,0,0,0,0,0,0,0,0,0,0,0,2,3,2,1,1,1,2,4,5,4,3,3,3,3,4,3,3,3,4,3,3,2,2,1,2,3,5,5,3,0,0,2,3,2,0,0,7,13,12,9,10,7,1,1,7,9,5,0,1,3,1,0,0
0,0,0,0,0,0,0,0,0,0,1,7,9,5,0,0,0,0,0,0,0,0,0,0,0,0,0,0,0,0,0,0,0,0,0,0,0,0,0,0,0,0,0,0,0,0,3,5,5,3,2,2,2,2,2,1,0,0,0,0,0,0,0,0,1,1,2,2,2,1,1,1,2,5,6,4,0,0,1,3,1,0,0,6,12,11,8,9,6,1,3,9,10,4,0,1,3,1,0,0
0,0,0,0,0,1,1,1,0,0,0,6,10,7,1,0,0,0,0,0,0,0,0,0,0,0,0,0,0,0,0,0,0,0,0,0,0,0,0,0,0,0,0,0,0,1,6,10,9,6,4,4,4,4,3,3,2,0,0,0,0,0,0,0,0,0,1,1,1,2,2,1,0,3,5,4,2,1,2,3,1,0,0,5,12,12,8,8,7,2,4,8,6,1,1,5,6,3,0,0
0,0,0,0,2,5,6,2,0,0,0,1,5,7,5,3,2,1,0,0,0,0,0,0,0,0,0,0,0,0,0,0,0,0,0,0,0,0,0,0,0,0,0,0,0,2,9,13,10,6,5,6,6,5,4,4,3,2,2,3,3,1,0,0,0,0,0,0,0,1,1,1,1,1,3,4,3,2,3,3,2,0,0,5,12,13,9,8,7,2,4,6,4,2,4,7,6,2,0,0
0,0,0,0,2,8,10,5,0,0,0,0,2,5,5,6,5,3,0,0,0,0,0,0,0,0,0,0,0,0,0,0,1,1,1,1,0,0,0,0,0,0,0,0,1,3,8,10,9,5,5,6,5,4,5,5,5,5,5,9,11,9,3,1,1,1,1,0,0,0,0,1,1,2,3,4,3,1,3,4,2,0,0,7,13,12,7,7,7,3,3,5,5,3,4,4,3,1,0,0
0,0,0,0,0,7,11,7,1,0,0,0,0,1,2,3,4,4,3,1,7,11,6,0,0,0,0,1,1,2,1,1,2,2,2,2,2,2,2,1,1,1,2,2,3,5,5,5,4,5,5,5,4,4,5,4,4,4,6,10,14,13,8,5,3,4,3,2,1,1,1,1,2,2,5,5,3,0,2,3,2,1,2,8,13,10,5,6,6,4,3,5,4,2,1,0,0,0,0,0
0,0,0,0,0,2,6,7,3,0,0,0,0,0,0,0,3,6,6,3,14,20,16,4,4,3,3,3,3,3,4,4,7,10,9,6,6,5,4,2,3,3,4,4,5,6,6,5,6,6,6,4,3,4,5,5,5,4,3,4,7,9,8,7,4,4,4,4,3,4,3,3,2,2,5,7,5,1,1,2,2,1,3,9,12,9,5,7,7,6,4,5,2,1,0,0,0,0,0,0
0,0,0,0,0,0,2,5,5,3,1,0,0,0,2,2,3,6,7,4,9,17,14,7,6,6,6,5,5,5,5,5,10,14,12,6,7,7,5,3,3,3,4,5,7,8,11,11,8,5,3,2,1,1,3,4,4,3,2,1,0,1,4,5,4,2,2,2,3,4,4,4,2,2,4,6,6,3,2,3,2,1,3,9,11,10,7,8,7,7,6,4,1,0,0,0,0,0,0,0
0,0,0,0,0,0,0,2,4,5,4,1,1,3,4,4,2,4,5,4,4,7,8,7,6,5,5,5,5,6,6,5,8,11,9,5,4,5,4,4,6,8,8,5,6,10,18,19,10,1,0,0,0,1,2,2,3,3,3,2,2,1,1,2,2,2,1,0,1,1,2,2,2,1,2,5,6,4,4,5,5,3,4,8,10,10,9,10,8,8,6,3,0,0,0,0,0,0,0,0
0,0,0,0,0,0,0,0,1,4,7,10,8,5,4,2,0,0,4,8,9,6,4,4,2,1,2,5,7,8,7,4,2,3,2,2,1,2,3,6,14,15,11,7,7,10,22,23,11,0,0,0,0,0,0,0,1,1,2,2,3,3,2,2,2,2,2,1,0,0,0,0,1,1,3,4,5,5,6,6,8,8,8,7,9,8,8,8,8,9,7,3,0,0,0,0,0,0,0,0
0,0,0,0,0,0,0,0,0,1,8,12,10,4,1,0,0,0,2,7,9,7,6,6,5,4,7,8,7,6,5,2,1,1,1,1,0,0,0,5,13,15,11,7,6,9,19,20,9,0,0,0,0,0,0,0,0,0,0,1,2,3,4,4,3,3,3,2,1,1,0,0,0,1,2,3,4,5,5,6,8,9,8,8,8,7,7,7,8,9,6,2,0,0,0,0,0,0,0,0
0,0,0,0,0,0,0,0,0,0,3,7,5,1,0,0,0,0,1,4,7,7,6,5,6,7,9,8,5,2,1,0,0,0,0,0,0,0,0,3,6,6,5,5,3,5,10,11,4,0,0,0,0,0,0,0,0,0,0,0,0,1,2,3,3,3,3,3,4,4,2,0,0,0,1,2,4,4,5,6,7,5,7,9,9,8,7,8,7,7,5,2,0,0,0,0,0,0,0,0
0,0,0,0,0,0,0,0,0,0,0,0,0,0,0,0,0,0,0,5,12,11,6,3,3,4,5,3,1,0,0,0,0,0,0,0,0,5,8,5,0,1,2,1,0,1,6,8,4,0,0,0,0,0,0,0,0,0,0,0,0,0,0,1,1,2,2,3,4,5,5,2,0,0,0,1,3,4,6,8,7,4,5,7,8,10,10,10,8,6,2,1,0,0,0,0,0,0,0,0
0,0,0,0,0,0,0,0,0,0,0,0,0,0,0,0,0,0,0,7,14,13,3,0,0,0,0,0,0,0,0,0,0,0,0,0,0,7,12,10,4,3,2,2,2,3,14,20,11,0,0,0,0,0,0,0,0,0,0,0,0,0,0,0,0,0,0,1,2,4,4,4,4,2,1,1,2,3,5,8,8,6,5,5,6,9,10,10,8,6,3,2,0,0,0,0,0,0,0,0
0,0,0,0,0,0,0,0,0,0,0,0,0,0,0,0,0,0,0,4,9,7,2,0,0,0,0,0,0,0,0,0,0,0,0,0,0,4,8,8,5,5,4,3,3,4,18,23,13,0,0,0,0,0,0,0,0,0,0,0,0,0,0,0,0,0,0,0,0,0,2,3,4,4,3,3,3,2,4,8,9,8,6,3,4,9,11,11,9,6,4,3,1,0,0,0,0,0,0,0
0,0,0,0,0,0,0,0,0,0,0,0,0,0,0,0,0,0,0,0,0,1,0,0,0,0,0,0,0,0,0,0,0,0,0,0,0,0,0,1,3,3,2,2,2,2,9,13,6,0,0,0,0,0,0,0,0,0,0,0,0,0,0,0,0,0,0,0,0,0,0,0,2,3,4,4,5,3,5,7,8,8,7,4,6,11,13,14,11,6,4,5,3,1,1,1,1,0,0,0
0,0,0,0,0,0,0,0,0,0,0,0,0,0,0,0,0,0,0,0,0,0,0,0,0,0,0,0,0,0,0,0,0,0,0,0,0,0,0,0,0,0,0,0,0,0,0,0,0,0,0,0,0,0,0,0,0,0,0,0,0,0,0,0,0,0,0,0,0,0,0,0,0,0,2,5,6,5,8,10,9,6,6,5,8,12,14,14,11,6,6,8,6,3,2,3,3,1,0,0
0,0,0,0,0,0,0,0,0,0,0,0,0,0,0,0,0,0,0,0,0,0,0,0,0,0,0,0,0,0,0,0,0,0,0,0,0,0,0,0,0,0,0,0,0,0,0,0,0,0,0,0,0,0,0,0,0,0,0,0,0,0,0,0,0,0,0,0,0,0,0,0,0,0,1,2,4,5,10,13,11,6,5,5,10,12,14,15,14,10,12,13,10,6,6,7,5,2,0,0
0,0,0,0,0,0,0,0,0,0,0,0,0,0,0,0,0,0,0,0,0,0,0,0,0,0,0,0,0,0,0,0,0,0,0,0,0,0,0,0,0,0,0,0,0,0,0,0,0,0,0,0,0,0,0,0,0,0,0,0,0,0,0,0,0,0,0,0,0,0,0,0,1,1,1,1,4,6,9,12,12,7,4,7,14,16,17,17,18,14,17,20,17,12,11,11,8,3,0,0
0,0,0,0,0,0,0,0,0,0,0,0,0,0,0,0,0,0,0,0,0,0,0,0,0,0,0,0,0,0,0,0,0,0,0,0,0,0,0,0,0,0,0,0,0,0,0,0,0,0,0,0,0,0,0,0,0,0,0,0,0,0,0,0,0,0,0,0,0,0,0,1,2,2,1,1,4,7,7,9,12,10,6,8,17,20,20,18,16,11,15,22,22,14,12,12,10,4,0,0
0,0,0,0,0,0,0,0,0,0,0,0,0,0,0,0,0,0,0,0,0,0,0,0,0,0,0,0,0,0,0,0,0,0,0,0,0,0,0,0,0,0,0,0,0,0,0,0,0,0,0,0,0,0,0,0,0,0,0,0,0,0,0,0,0,0,0,0,0,0,1,2,2,1,2,3,5,7,7,11,15,12,6,11,17,20,19,18,12,6,10,18,17,10,6,8,10,5,0,0
0,0,0,0,0,0,0,0,0,0,0,0,0,0,0,0,0,0,0,0,0,0,0,0,0,0,0,0,0,0,0,0,0,0,0,0,0,0,0,0,0,0,0,0,0,0,0,0,0,0,0,0,0,0,0,0,0,0,0,0,0,0,0,0,0,0,0,0,0,0,2,4,2,0,3,5,6,5,7,15,19,14,7,10,17,20,23,21,12,6,10,13,9,3,2,8,10,6,0,0
0,0,0,0,0,0,0,0,0,0,0,0,0,0,0,0,0,0,0,0,0,0,0,0,0,0,0,0,0,0,0,0,0,0,0,0,0,0,0,0,0,0,0,0,0,0,0,0,0,0,0,0,0,0,0,2,4,2,0,0,0,0,0,0,0,0,0,0,0,0,3,4,3,1,5,7,5,4,7,15,21,20,13,12,18,24,26,22,13,11,15,13,5,1,3,11,13,6,0,0
0,0,0,0,0,0,0,0,0,0,0,0,0,0,0,0,0,0,0,0,0,0,0,0,0,0,0,0,0,0,0,0,0,0,0,0,0,0,0,0,0,0,0,0,0,0,0,0,0,0,0,0,0,0,0,6,9,6,0,0,0,0,0,0,0,0,0,0,0,0,2,4,2,2,5,6,4,4,6,11,17,21,17,14,19,27,28,20,12,15,18,14,5,3,5,13,15,7,0,0
0,0,0,0,0,0,0,0,0,0,0,0,0,0,0,0,0,0,0,0,0,0,0,0,0,0,0,0,0,0,0,0,0,0,0,0,0,0,0,0,0,0,0,0,0,0,0,0,0,0,0,0,0,0,0,5,10,7,1,0,0,0,0,0,0,0,0,0,0,0,7,13,8,3,6,5,6,10,11,10,13,17,18,16,21,27,27,18,11,15,18,13,7,8,7,13,15,8,0,0
0,0,0,0,0,0,0,4,6,4,0,0,0,0,0,0,0,0,0,0,0,0,0,0,0,0,0,0,0,0,0,0,0,0,0,0,0,0,0,0,0,0,0,0,0,0,0,0,0,0,0,0,0,0,0,1,6,6,3,0,0,0,0,0,0,0,0,0,0,0,13,21,16,8,13,13,14,18,20,15,18,21,20,18,23,27,28,21,19,25,23,12,8,11,11,13,13,7,0,0
0,0,0,0,0,0,0,6,11,10,3,0,0,0,0,0,0,0,0,0,0,0,0,0,0,0,0,0,0,0,0,0,0,0,0,0,0,0,0,0,0,0,1,0,0,0,0,0,0,0,0,0,1,1,0,0,3,7,7,2,0,0,0,0,0,0,0,0,0,0,10,20,18,15,21,23,22,24,25,23,28,28,21,18,22,26,29,30,37,48,45,22,15,20,18,15,11,6,0,0
0,0,0,0,0,0,0,4,9,9,6,3,1,0,0,0,0,0,0,0,0,0,0,0,0,0,0,0,0,0,0,0,0,0,0,0,0,0,0,0,0,4,6,4,0,0,0,0,0,0,0,3,6,4,0,0,1,7,9,5,0,0,0,0,0,0,0,0,0,0,8,22,27,24,28,30,28,24,25,28,35,35,24,17,22,29,38,39,43,54,50,28,18,22,21,19,15,7,0,0
0,0,0,0,0,0,0,0,1,4,6,4,3,1,0,0,0,0,0,0,0,0,0,0,0,0,0,0,0,0,0,0,0,0,0,0,0,0,0,0,0,6,10,7,0,0,0,0,0,0,0,6,9,6,0,0,0,8,13,8,0,0,0,0,0,0,0,0,0,0,18,42,46,37,40,40,31,22,21,27,33,34,25,16,19,29,39,36,28,34,38,24,14,19,21,25,23,10,0,0
0,0,0,0,0,0,0,0,0,0,1,3,3,3,2,0,0,0,0,0,0,0,0,0,0,0,0,0,0,0,0,0,0,0,0,0,0,0,0,0,0,4,8,6,1,0,0,0,0,0,0,4,7,4,0,0,0,7,12,9,0,0,0,0,0,0,0,0,0,0,26,53,54,37,41,43,37,26,22,26,31,28,22,15,16,27,33,25,10,15,25,20,11,12,17,25,24,11,0,0
0,0,0,0,1,1,0,0,0,0,0,0,1,3,3,2,0,0,0,0,0,0,0,0,0,0,0,0,0,0,0,0,0,0,0,0,0,0,0,0,0,0,3,4,2,6,10,6,0,0,0,0,2,3,1,0,0,4,9,8,2,0,0,0,0,0,0,0,0,0,22,43,37,19,23,32,39,40,37,33,28,23,18,17,20,27,29,21,8,15,27,25,13,12,13,18,16,8,0,0
0,0,0,3,6,5,1,0,0,0,0,0,0,1,2,2,3,4,2,0,0,0,0,0,0,0,0,0,0,0,0,0,1,4,5,3,0,0,0,0,0,0,2,3,2,12,18,12,0,0,0,0,2,3,2,0,0,0,4,5,3,0,1,0,0,0,0,0,0,0,15,26,18,5,10,21,38,69,87,70,39,26,23,25,25,32,33,25,14,19,27,26,12,6,8,13,10,5,0,0
0,0,0,4,8,8,4,2,0,0,0,0,0,0,0,1,6,9,7,1,0,0,0,0,0,0,0,0,0,0,0,0,1,6,8,7,1,0,0,0,0,0,1,3,2,17,28,16,0,0,0,0,1,3,1,0,0,0,2,4,3,5,8,5,0,0,0,0,0,0,46,91,79,47,52,63,72,103,122,116,74,52,32,27,28,37,47,56,58,65,78,72,45,23,26,54,63,30,0,0
0,0,0,2,5,5,4,4,3,1,0,0,0,0,0,0,5,10,8,3,0,0,0,0,0,0,0,0,0,0,0,0,0,3,6,6,3,1,0,0,0,0,0,2,2,21,30,18,0,0,0,0,1,2,1,0,0,0,1,3,3,8,11,7,0,0,0,0,0,0,68,120,119,71,72,82,83,90,98,101,89,77,55,39,33,40,55,67,77,84,98,92,63,34,33,79,85,50,0,0
0,0,0,0,0,0,2,3,3,3,2,1,0,0,0,0,1,4,6,5,2,0,0,0,0,0,0,0,1,0,0,0,0,0,0,2,3,3,1,0,0,0,0,0,1,17,25,15,0,0,0,0,0,3,4,2,0,0,0,2,3,7,9,6,0,0,5,9,5,0,36,77,70,42,41,47,47,36,29,41,61,71,66,53,41,40,43,45,44,50,57,54,36,20,20,45,55,27,0,0
0,0,0,0,0,0,0,0,2,3,2,2,1,0,0,0,0,0,2,3,4,2,0,0,0,0,0,3,6,3,0,0,0,0,0,0,2,3,3,2,0,0,0,0,0,6,9,5,0,0,0,0,0,5,7,5,0,0,0,2,3,3,4,4,1,0,11,16,10,0,0,0,0,0,0,0,0,0,0,6,19,42,55,53,41,40,29,12,0,0,0,0,0,0,0,0,0,0,0,0
0,0,0,0,0,0,0,0,0,1,1,1,1,1,1,0,0,0,0,1,3,3,2,0,0,0,0,5,8,5,0,0,0,0,0,0,0,1,3,3,2,0,0,0,0,4,7,4,0,0,0,0,0,4,7,5,0,0,0,1,2,2,5,7,4,1,10,15,9,0,0,0,0,0,0,0,0,0,0,7,16,26,36,41,41,44,34,11,0,0,0,0,0,0,0,0,0,0,0,0
0,0,0,0,0,0,0,0,0,0,0,0,1,2,2,1,0,0,0,0,1,3,3,2,0,0,0,3,7,6,1,0,0,0,0,0,0,1,3,4,4,4,2,0,0,10,15,9,0,0,0,0,0,1,5,7,3,0,0,0,1,2,7,10,7,1,5,7,3,0,0,0,0,0,0,0,0,0,1,8,13,18,26,35,42,46,36,13,0,0,0,0,0,0,0,0,0,0,0,0
0,0,0,0,0,0,0,0,0,0,0,0,0,1,2,1,0,0,0,0,0,0,2,2,1,0,0,0,3,4,4,3,3,2,1,0,1,2,3,3,5,7,9,7,4,15,21,13,0,0,0,0,0,0,6,9,6,0,0,0,1,2,8,14,12,3,2,3,1,0,0,0,0,0,0,1,1,2,2,7,9,9,15,30,39,44,36,19,4,0,0,0,0,0,0,0,0,0,0,0
0,0,0,0,0,0,0,0,0,0,0,0,0,0,1,1,3,3,1,0,0,0,0,1,2,1,0,0,1,3,4,4,4,4,2,2,4,4,3,2,2,7,10,10,5,14,18,11,0,0,0,0,0,0,4,8,5,0,0,0,1,2,6,14,15,6,1,2,1,0,0,0,0,0,1,3,4,4,4,4,4,4,10,22,33,38,35,23,9,1,1,0,0,0,0,0,0,0,0,0
0,0,0,0,0,0,0,0,0,0,0,0,0,0,0,1,5,7,6,3,2,1,0,1,2,2,1,0,0,0,1,2,3,2,2,3,7,8,5,1,0,2,5,6,5,11,14,7,0,0,0,0,0,0,1,3,3,1,0,0,0,1,4,14,18,10,5,10,5,0,0,0,0,0,2,4,5,6,4,3,3,4,7,15,25,34,35,26,14,5,3,1,0,0,0,0,0,0,0,0
0,0,0,0,0,0,0,0,0,0,0,0,0,0,0,0,3,7,7,5,4,3,2,1,1,1,1,1,0,0,0,0,0,0,0,2,7,10,9,5,4,4,3,3,3,9,11,6,0,0,0,0,0,0,0,1,3,2,0,0,0,1,1,12,17,14,17,22,13,0,0,0,0,1,3,3,4,5,4,2,3,5,6,11,20,33,33,27,17,11,4,2,0,0,0,0,0,0,0,0
0,0,0,0,0,0,0,0,0,0,0,0,0,0,0,0,0,2,3,3,2,2,3,3,2,1,1,1,1,0,0,0,0,0,1,1,3,7,11,12,9,8,8,6,5,14,18,10,0,0,0,0,0,0,0,1,2,2,1,0,0,0,1,8,14,16,31,40,21,0,0,0,0,1,3,3,3,4,2,1,2,5,7,10,20,32,30,25,20,16,6,3,0,0,0,0,0,0,0,0
0,0,0,0,0,0,0,0,0,0,0,0,0,0,0,0,0,0,0,0,0,0,1,2,3,3,2,1,2,6,6,3,0,0,1,2,1,5,17,21,13,8,8,8,8,27,35,20,0,0,0,0,0,0,0,0,2,2,1,0,0,0,1,4,10,17,41,48,26,0,0,0,0,0,3,4,4,5,4,1,2,5,7,9,20,30,26,18,21,21,11,2,0,0,0,0,0,0,0,0
0,0,0,0,0,0,0,0,0,0,0,0,0,0,0,0,0,0,0,0,0,0,0,0,2,3,2,1,3,9,12,8,2,3,4,3,2,7,20,22,13,5,5,6,9,32,40,23,0,0,0,0,0,0,0,0,1,2,1,0,0,0,1,3,11,20,46,52,28,0,0,0,0,0,3,5,5,5,6,4,3,5,7,8,17,25,23,15,21,23,15,2,0,0,0,0,0,0,0,0
0,0,0,0,0,0,0,0,0,0,0,0,0,0,0,0,0,0,0,0,0,0,0,0,0,1,1,1,2,7,10,8,4,5,6,5,5,7,13,14,11,7,5,4,6,19,24,13,0,0,0,0,0,0,0,0,0,1,1,1,0,0,1,3,13,24,52,55,29,0,0,0,0,1,4,6,8,8,9,7,5,5,7,8,14,21,23,16,18,25,19,5,0,0,0,0,0,0,0,0
0,0,0,0,0,0,0,0,0,0,0,0,0,0,0,0,0,0,0,4,6,5,2,0,0,0,0,1,1,2,3,4,4,5,5,6,5,5,4,6,10,12,10,9,6,9,12,7,0,0,0,0,0,0,0,0,0,0,1,2,1,3,5,6,12,24,47,45,23,0,0,0,2,2,3,6,9,9,9,7,5,3,6,9,15,23,27,21,18,24,23,9,0,0,0,0,0,0,0,0
0,0,0,0,0,0,0,0,0,0,0,0,0,0,0,0,0,0,1,6,9,8,3,2,2,1,0,0,1,2,1,1,2,4,4,4,3,2,1,4,9,12,14,16,13,15,15,10,0,0,0,0,0,0,0,0,0,0,2,4,4,6,9,10,12,20,28,26,14,8,9,8,8,7,3,3,6,7,7,7,4,2,4,9,18,29,33,23,15,23,28,15,1,0,0,0,0,0,0,0
0,0,0,0,0,0,0,0,0,0,0,0,0,0,0,0,0,0,0,4,6,5,2,3,3,3,2,1,2,2,1,1,3,5,6,4,1,0,1,5,7,10,14,22,19,20,19,10,0,0,0,0,0,0,0,1,3,4,4,9,12,11,8,9,12,19,26,27,23,20,20,14,10,8,7,6,7,5,6,8,8,6,6,7,15,29,32,22,11,21,31,21,5,1,0,0,0,0,0,0
0,0,0,0,0,0,0,0,0,0,0,0,0,0,0,0,0,0,0,0,0,0,0,1,2,2,2,5,8,8,6,10,14,14,13,11,7,4,3,7,9,10,12,18,19,18,16,12,7,6,4,5,6,6,6,6,7,7,6,14,22,20,9,7,14,24,37,43,38,27,24,20,13,14,15,13,13,13,13,10,10,12,12,8,11,24,30,22,11,20,29,23,9,4,0,0,0,0,0,0
0,0,0,0,0,0,0,0,0,0,0,0,0,0,0,0,0,0,0,0,0,0,0,0,0,0,2,7,11,11,8,15,19,18,16,15,12,9,8,10,13,15,14,16,20,26,26,22,17,14,12,11,11,12,13,14,13,11,9,19,33,31,18,12,22,32,41,45,39,27,21,18,16,19,23,22,20,23,23,18,12,15,18,18,17,23,29,24,15,17,24,21,14,9,3,1,2,1,0,0
0,0,0,0,0,0,0,0,0,0,0,0,0,0,0,0,0,0,0,0,0,0,0,0,0,0,1,4,7,6,5,8,11,11,10,12,12,10,12,15,16,16,13,12,20,29,31,24,17,14,13,14,16,16,16,16,15,13,15,23,31,32,22,21,37,47,43,40,40,31,24,22,22,25,29,28,26,28,30,27,23,21,24,29,33,32,31,25,17,16,21,21,18,14,9,5,5,3,0,0
0,0,0,0,0,0,0,0,0,0,0,0,0,0,0,0,0,0,0,0,0,0,0,0,0,0,0,1,0,0,0,0,0,1,4,6,6,6,10,14,14,11,9,10,16,22,20,16,10,10,12,14,15,15,14,14,14,14,17,19,20,19,17,24,39,48,51,50,42,32,26,22,20,21,24,27,26,22,25,29,32,30,30,31,39,38,33,24,21,21,24,24,22,18,13,12,10,4,0,0
0,0,0,0,0,0,0,0,0,0,0,0,0,0,0,0,0,0,0,0,0,0,0,0,0,0,0,0,0,0,0,0,0,2,4,5,4,1,3,7,7,4,4,7,11,11,8,10,13,14,16,15,14,11,10,9,9,10,12,12,10,8,13,21,26,38,56,57,41,27,26,24,19,15,14,15,15,14,19,25,35,39,37,28,31,35,33,27,24,24,27,26,23,17,13,14,13,6,0,0
0,0,0,0,0,0,0,0,3,3,1,0,0,0,0,0,0,0,0,0,0,0,0,0,0,0,0,1,1,1,2,1,1,1,3,5,5,2,0,0,1,1,2,4,10,14,22,24,22,18,16,11,7,4,4,5,6,6,6,8,8,9,13,16,13,26,48,52,29,18,18,17,16,12,10,9,8,7,15,21,29,37,39,28,23,28,32,30,26,25,26,27,22,12,7,13,16,9,0,0
0,0,0,0,0,0,0,1,6,8,6,2,0,0,0,0,0,0,0,0,0,0,1,1,1,2,4,6,7,6,5,3,1,0,1,3,5,4,2,0,0,0,1,1,7,19,29,30,21,11,8,6,4,2,2,3,3,3,2,3,7,12,14,13,14,29,47,42,20,8,7,12,14,13,11,11,9,7,11,13,17,25,32,31,27,30,36,41,31,24,26,30,23,13,6,15,21,13,0,0
0,0,0,0,0,0,0,0,5,8,7,3,2,2,2,2,1,1,1,0,1,3,3,2,3,6,11,12,9,8,6,4,3,2,1,1,4,5,4,1,0,0,0,3,10,18,24,19,9,3,3,3,4,3,3,3,3,1,1,2,6,14,17,14,18,33,51,44,18,0,2,8,14,15,12,10,13,14,15,11,11,16,26,36,36,35,45,50,35,24,28,32,28,25,23,35,37,18,0,0
0,0,0,0,0,0,0,0,1,2,3,2,3,3,3,3,3,2,3,7,8,6,4,2,1,7,10,10,5,3,3,3,4,5,7,5,3,3,5,3,2,2,5,8,11,15,13,5,1,0,1,3,3,2,1,1,1,0,1,5,12,20,23,20,23,39,60,51,22,0,4,9,16,16,13,10,15,23,26,23,22,21,28,39,43,40,49,52,35,23,26,28,31,33,34,50,54,27,0,0
0,0,0,0,0,0,0,0,0,0,0,0,1,2,2,2,1,1,4,10,11,7,1,0,0,2,4,2,0,0,0,1,2,6,10,10,6,5,7,9,10,9,10,9,9,12,12,5,0,0,0,1,1,0,0,1,2,1,2,8,19,29,29,23,21,33,59,57,25,0,5,11,16,19,19,14,14,20,27,33,33,28,31,39,44,41,49,50,41,35,36,34,33,32,27,48,56,31,0,0
0,0,0,0,0,0,0,0,0,0,0,0,0,0,0,0,0,0,2,6,6,2,0,0,0,0,0,0,0,0,0,0,0,2,6,7,6,7,10,14,15,15,12,7,6,10,11,5,0,0,0,0,0,0,0,3,6,4,2,6,17,29,29,19,12,21,52,59,29,0,4,10,15,18,19,15,8,9,18,28,32,29,31,36,39,40,50,55,51,48,47,42,35,26,14,31,43,25,0,0
0,0,0,0,0,0,0,0,0,0,0,0,0,0,0,0,0,0,0,0,0,0,0,0,0,0,0,0,0,0,0,0,0,0,0,1,5,10,10,10,12,12,8,5,7,15,15,7,0,0,0,0,0,0,0,4,8,6,1,3,11,23,26,15,4,6,45,64,37,0,2,10,13,14,14,12,8,8,13,19,25,29,35,34,31,34,51,56,48,43,46,41,32,25,17,31,39,20,0,0
0,0,0,0,0,0,0,0,0,0,0,0,0,0,0,0,0,0,0,0,0,0,0,0,0,0,0,0,0,0,0,0,0,0,0,0,4,8,7,2,3,4,4,5,9,18,19,9,0,0,0,0,0,0,0,3,5,4,1,7,14,23,21,12,1,3,42,62,38,0,2,7,11,9,10,13,14,15,16,18,25,34,36,30,24,26,44,51,39,32,36,31,23,22,25,38,37,18,0,0
0,0,0,0,0,0,0,0,0,0,0,0,0,0,3,6,4,2,2,1,1,2,1,1,1,1,1,0,1,5,10,12,9,5,2,1,3,6,4,2,1,1,3,4,6,16,19,10,0,0,0,0,0,0,2,7,8,7,8,17,19,22,20,14,5,13,61,82,44,0,30,65,63,45,55,64,59,47,52,61,58,48,37,27,21,23,41,52,56,64,77,68,60,65,76,101,93,40,0,0
0,0,0,0,0,0,0,0,0,0,0,0,0,1,6,9,7,4,3,3,3,3,3,2,2,2,1,1,1,8,15,19,14,8,3,2,1,2,3,3,3,3,3,3,1,9,12,7,0,0,0,0,0,0,4,9,11,9,12,15,15,13,14,11,6,17,61,72,40,0,51,89,95,65,80,86,77,58,68,86,92,70,44,29,28,35,58,93,111,99,94,84,79,84,98,125,107,53,0,0
0,0,0,0,0,0,0,0,0,0,0,0,0,0,3,6,4,2,2,1,1,2,1,1,1,1,1,0,1,5,10,12,9,5,2,1,1,1,1,2,1,1,1,0,0,3,5,3,0,0,0,0,0,0,2,6,7,5,7,7,3,3,6,5,3,9,31,39,18,0,29,60,55,39,47,52,44,32,38,59,74,68,50,37,36,47,79,119,114,82,53,49,46,50,55,70,67,29,0,0
0,0,0,0,0,0,0,0,0,0,0,0,0,0,0,0,0,0,0,0,0,0,0,0,0,0,0,0,0,0,0,0,0,0,0,0,0,0,0,0,0,0,0,0,0,0,0,0,0,0,0,0,0,0,0,0,0,0,0,0,0,0,0,0,0,0,0,0,0,0,0,0,0,0,0,0,0,0,0,8,27,39,37,33,32,41,67,88,68,22,0,0,0,0,0,0,0,0,0,0
0,0,0,0,0,0,0,0,0,0,0,0,0,0,0,0,0,0,0,0,0,0,0,0,0,0,0,0,0,0,0,0,0,0,0,0,0,0,0,0,0,0,0,0,0,0,0,0,0,0,0,0,0,0,0,0,0,0,0,0,0,0,0,0,0,0,0,0,0,0,0,0,0,0,0,0,0,0,0,0,3,11,16,17,14,20,33,31,12,0,0,0,0,0,0,0,0,0,0,0
