0,0,0,0,0,0,0,0,0,0,0,0,0,0,0,0,0,0,0,0,0,0,0,0,0,0,0,0,0,0,0,0,0,0,0,0,0,0,0,0,0,0,0,0,0,0,0,0,0,0,0,0,0,0,0,0,0,0,0,0,0,0,0,0,0,0,0,0,0,0,0,0,0,0,0,0,0,0,0,0,0,0,0,0,0,0,0,0,0,0,0,0,0,0,0,0,0,0,0,0
0,0,0,0,0,0,0,0,0,0,0,0,0,0,0,0,0,0,0,0,0,0,0,0,0,0,0,0,0,0,0,0,0,0,0,0,0,0,0,0,0,0,0,0,0,0,0,0,0,0,0,0,0,0,0,0,0,0,0,0,0,0,0,0,1,4,5,4,2,0,0,0,1,3,5,9,10,8,6,6,6,6,6,6,6,6,6,5,5,5,5,6,5,4,3,2,0,0,0,0
0,0,0,0,0,0,0,0,0,0,0,0,0,0,0,0,0,0,0,0,0,0,0,0,0,0,0,0,0,0,0,0,0,0,0,0,0,0,0,0,0,0,0,0,0,0,0,0,0,0,0,0,0,0,0,0,0,0,0,0,0,0,0,0,3,6,11,10,5,2,3,4,5,7,11,15,19,17,12,11,11,11,11,12,13,12,11,10,10,9,9,9,9,9,6,5,4,1,0,0
0,0,0,0,0,0,0,0,0,0,0,0,0,0,0,0,0,0,0,0,0,0,0,0,0,0,0,0,0,0,0,0,0,0,0,0,0,0,0,0,0,0,0,0,0,0,0,0,0,0,0,0,0,0,0,0,0,0,0,0,0,0,0,1,4,7,10,13,12,10,11,10,8,10,12,15,17,17,14,12,12,13,14,14,13,12,12,11,11,11,9,7,7,7,7,8,6,3,0,0
0,0,0,0,0,0,0,0,0,0,0,1,3,4,4,2,1,1,2,2,1,1,1,2,1,0,0,0,0,0,0,0,0,0,0,0,0,0,0,0,0,0,0,0,0,0,0,0,0,0,0,0,0,0,0,0,0,0,0,0,0,1,2,3,4,4,6,11,15,16,18,21,20,19,15,10,8,11,11,9,8,9,10,10,9,7,7,8,9,8,8,7,4,3,4,7,8,3,0,0
0,0,0,0,0,0,0,0,0,0,0,2,4,7,6,4,2,3,4,4,3,2,3,3,2,1,1,1,2,2,1,1,1,2,1,1,1,0,0,0,0,0,0,0,0,0,0,0,0,0,0,0,0,0,0,0,0,0,1,1,2,3,3,3,3,2,5,15,24,22,21,26,31,32,26,15,7,9,10,11,10,8,6,6,6,6,6,6,7,8,9,11,11,6,2,6,8,4,0,0
0,0,0,0,0,0,0,0,0,0,0,1,3,4,4,2,1,1,2,2,1,1,1,2,1,0,0,1,2,2,2,2,3,3,3,2,1,1,1,1,1,1,1,1,1,0,1,1,1,0,0,0,0,0,0,0,2,3,3,4,4,4,3,3,3,3,11,27,34,29,21,22,26,32,29,16,5,5,7,9,10,7,4,4,5,6,5,5,5,5,6,10,13,11,5,6,9,5,0,0
0,0,0,0,0,0,0,2,5,6,3,2,2,3,2,2,2,1,1,1,1,2,2,2,2,2,1,1,2,3,3,3,3,2,1,1,1,0,1,2,2,2,2,2,1,1,1,2,2,2,2,3,3,3,4,5,6,7,6,6,5,4,3,5,6,9,20,34,38,30,20,16,17,22,23,16,9,6,6,8,10,9,6,4,4,6,8,6,5,4,4,5,8,9,7,9,10,6,0,0
0,0,0,0,0,0,0,3,8,9,6,3,4,4,4,3,3,3,2,2,3,3,3,3,3,3,3,2,2,3,3,3,2,2,1,1,1,1,2,3,3,3,3,3,3,3,5,6,6,6,6,6,7,6,8,9,9,8,7,5,5,5,7,9,9,14,35,50,39,22,16,15,14,14,14,13,11,8,7,7,10,12,10,4,3,3,5,7,7,5,4,4,3,3,6,13,14,7,0,0
0,0,0,0,0,0,0,2,5,6,3,2,2,3,2,2,2,1,1,1,1,2,2,2,2,2,1,1,1,1,2,1,2,3,3,2,2,3,3,3,2,2,3,3,3,3,6,8,9,8,7,6,6,5,5,7,7,6,5,5,4,6,9,11,10,14,41,53,38,12,8,9,9,7,6,7,8,6,6,5,8,13,14,8,3,2,3,5,7,8,7,5,2,1,3,13,17,10,0,0
0,0,0,0,0,0,0,0,0,0,0,0,0,0,0,0,0,0,0,0,0,0,0,0,0,0,0,0,0,0,0,0,0,1,1,1,1,1,2,3,3,2,1,2,2,3,6,8,7,6,4,4,4,4,3,4,4,3,2,3,4,6,10,11,8,11,33,44,25,3,2,1,1,1,0,1,1,1,1,1,3,8,13,12,6,2,1,3,6,10,10,7,3,1,0,12,18,11,0,0
0,0,0,0,0,0,0,0,0,0,0,0,0,0,0,0,0,0,0,0,0,0,0,0,0,0,0,0,0,0,0,0,0,0,0,0,0,0,0,2,4,6,4,2,1,2,4,3,3,3,3,4,5,4,4,4,3,4,5,5,4,7,12,10,3,7,29,37,18,0,0,0,0,0,1,0,0,0,0,0,0,2,7,11,8,4,1,2,3,7,9,11,6,2,0,11,18,11,0,0
0,0,0,0,0,0,0,0,0,0,0,0,0,0,0,0,0,0,0,0,0,0,0,0,0,0,0,0,0,0,0,0,0,0,0,0,0,0,0,1,5,7,6,4,2,3,4,4,4,4,4,4,4,4,5,6,6,5,6,7,7,13,16,12,3,9,39,49,26,0,0,0,0,2,4,2,0,0,0,0,0,0,2,7,10,7,2,0,1,2,7,12,10,5,1,10,16,10,0,0
0,0,0,0,0,0,0,0,0,0,0,0,0,0,0,0,0,0,0,0,0,0,0,0,0,0,0,0,0,0,0,0,0,0,0,0,0,0,0,0,3,6,6,5,5,4,4,3,3,4,4,3,3,5,7,7,5,4,5,6,7,14,19,15,6,12,37,44,22,0,0,0,0,3,5,3,0,0,0,0,0,0,0,6,10,9,4,0,0,0,3,8,11,8,4,11,17,10,0,0
0,0,0,0,0,0,0,0,0,0,0,0,0,0,0,0,0,0,0,0,0,0,0,0,0,0,0,0,0,0,0,0,0,0,0,1,1,1,1,3,4,4,4,4,5,4,3,2,1,1,2,1,3,7,8,6,3,2,4,5,7,13,15,12,6,9,22,26,12,0,0,0,0,3,5,4,0,0,0,0,0,0,0,4,8,9,5,1,0,0,0,4,10,10,6,12,18,11,0,0
0,0,0,0,0,0,0,0,0,0,0,0,0,0,0,0,0,0,0,0,0,0,0,0,0,0,0,0,0,0,0,1,3,3,2,3,4,4,4,5,5,3,3,3,2,1,1,0,1,2,3,3,4,6,5,3,3,5,5,5,5,7,7,5,3,3,12,16,9,0,0,0,0,1,4,4,1,0,0,0,0,0,0,2,6,8,6,2,0,0,0,2,7,10,6,12,18,11,0,0
0,0,0,0,0,0,0,0,0,0,0,0,0,0,0,0,0,0,0,0,0,0,0,0,0,0,0,0,3,4,3,5,7,6,4,4,4,4,4,3,2,1,0,0,0,0,1,3,4,5,4,3,3,3,3,4,5,5,5,4,4,3,1,0,0,0,13,22,13,0,0,0,0,1,3,3,1,0,0,0,0,0,0,1,4,7,6,3,1,0,0,1,6,9,6,12,16,10,0,0
0,0,0,0,0,0,0,0,0,0,0,0,0,0,0,0,0,0,0,0,0,0,0,0,0,0,0,4,10,10,7,5,6,6,3,2,1,2,1,0,0,0,0,0,0,2,4,6,5,4,2,1,1,3,4,4,4,2,1,2,2,0,0,0,0,0,17,28,17,0,0,0,2,3,3,1,1,0,0,0,0,0,0,0,3,6,7,5,2,0,0,0,4,9,7,12,16,10,0,0
0,0,0,0,0,0,0,0,0,0,0,0,0,0,0,0,0,0,0,0,0,0,0,0,1,1,2,6,10,10,5,2,2,1,1,0,0,0,0,0,1,2,3,2,3,4,5,5,3,1,0,1,2,3,3,1,0,0,2,2,1,0,0,0,0,0,13,21,13,0,0,0,3,5,4,1,0,0,0,0,0,0,0,0,1,5,8,6,2,0,0,0,4,8,7,13,17,10,0,0
0,0,0,0,0,0,0,0,0,0,0,0,0,0,0,0,0,0,0,1,2,2,1,1,1,3,3,4,4,3,1,0,0,0,0,0,0,0,1,3,5,6,6,5,3,3,2,1,0,0,2,2,2,2,1,0,0,2,3,2,0,0,0,0,0,0,4,8,4,0,0,0,4,6,5,1,1,0,0,0,0,0,0,0,1,6,8,6,3,0,0,0,3,6,7,14,18,10,0,0
0,0,0,0,0,0,0,0,0,0,0,0,0,0,0,0,1,2,3,3,3,3,2,1,1,1,1,0,0,0,0,0,0,0,0,0,0,0,2,6,7,7,5,4,2,1,0,0,0,2,2,2,1,1,0,0,2,3,3,0,0,0,0,0,0,0,0,0,0,0,0,0,3,5,5,2,1,0,0,0,0,0,0,0,1,5,6,7,7,5,1,0,3,5,6,14,18,9,0,0
0,0,0,0,0,0,0,0,0,0,0,0,2,4,4,2,2,4,4,3,2,2,1,0,0,0,0,0,0,0,0,0,0,0,0,0,1,1,4,6,6,3,2,1,0,0,0,1,1,1,2,0,0,0,0,1,3,3,1,0,0,0,0,0,0,0,0,0,0,0,0,0,2,3,3,2,1,0,0,0,0,0,0,0,0,3,5,9,12,9,2,0,2,5,6,13,16,9,0,0
0,0,0,0,0,0,0,0,0,0,0,1,5,7,6,3,2,2,2,0,0,0,0,0,0,0,0,0,0,0,0,0,0,1,2,2,2,3,3,3,2,1,0,0,0,1,3,2,1,0,0,0,0,0,0,2,2,1,0,0,0,0,0,0,0,0,0,0,0,0,0,0,1,1,3,3,1,0,0,0,0,0,0,0,0,2,5,11,14,9,1,0,2,5,7,14,16,8,0,0
0,0,0,0,0,0,0,0,0,0,0,2,5,6,4,1,0,0,0,0,0,0,0,0,0,0,0,0,1,2,1,1,1,2,3,2,2,2,2,1,0,0,1,2,2,3,3,2,0,0,0,0,0,0,2,2,1,0,0,0,0,0,0,0,0,0,0,0,0,0,0,0,0,1,2,2,1,0,0,0,0,0,0,0,0,1,5,11,11,5,0,0,2,5,9,16,16,7,0,0
0,0,0,0,0,0,0,0,0,0,0,1,2,1,0,0,0,0,0,0,0,0,0,0,0,2,3,2,3,3,3,1,1,1,2,1,2,4,5,4,2,1,2,4,3,2,1,0,0,0,0,0,1,4,5,3,0,0,0,0,0,0,0,0,0,0,0,0,0,0,0,0,1,1,2,2,1,0,0,0,0,0,0,0,0,1,6,10,9,4,1,0,2,5,10,17,15,6,0,0
0,0,0,0,0,0,0,0,0,0,0,0,0,0,0,0,0,0,0,0,3,5,5,3,2,3,4,3,2,2,1,1,0,0,0,0,2,6,8,6,3,2,2,2,2,0,0,0,0,0,0,0,4,7,6,2,0,0,0,0,0,0,0,0,0,0,0,0,0,0,0,0,1,2,2,1,1,0,0,0,0,0,0,0,0,2,10,12,8,3,1,1,2,3,9,17,14,5,0,0
0,0,0,0,0,0,0,0,0,0,0,0,0,0,0,0,0,0,0,1,4,8,8,4,2,2,3,2,0,0,0,0,0,0,0,0,1,3,5,4,2,1,0,0,0,0,0,0,0,0,0,1,4,6,4,0,0,0,0,0,0,0,0,0,0,0,0,0,0,0,0,0,1,3,3,2,1,0,0,0,0,0,0,0,0,7,16,16,7,3,2,1,2,3,8,16,14,6,0,0
0,0,0,0,0,0,0,0,0,0,0,0,0,0,0,0,0,0,0,0,3,5,5,3,0,0,0,0,0,0,0,0,0,0,0,0,0,0,0,0,0,0,0,0,0,0,0,0,0,0,0,0,2,2,0,0,0,0,0,0,0,0,0,0,0,0,0,0,0,0,0,0,2,3,2,1,2,1,0,0,0,0,0,0,0,8,17,15,6,3,1,1,3,6,9,15,13,6,0,0
0,0,0,0,0,0,0,0,0,0,0,0,0,0,0,0,0,0,0,0,0,0,0,0,0,0,0,0,0,0,0,0,0,0,0,0,0,0,0,0,0,0,0,0,0,0,0,0,0,0,0,0,0,0,0,0,0,0,0,0,0,0,0,0,0,0,0,0,0,0,0,0,1,3,1,1,2,1,0,0,0,0,0,0,0,5,11,10,5,3,3,4,6,9,11,14,11,5,0,0
0,0,0,0,0,0,0,0,0,0,0,0,0,0,0,0,0,0,0,0,0,0,0,0,0,0,0,0,0,0,0,0,0,0,0,0,0,0,0,0,0,0,0,0,0,0,0,0,0,0,0,0,0,0,0,0,0,0,0,0,0,0,0,0,0,0,0,0,0,0,0,0,1,2,1,1,1,1,0,0,0,0,0,0,1,5,8,8,6,3,5,5,7,8,10,11,10,5,0,0
0,0,0,0,0,0,0,0,0,0,0,0,0,0,0,0,0,0,0,0,0,0,0,0,0,0,0,0,0,0,0,0,0,0,0,0,0,0,0,0,0,0,0,0,0,0,2,4,2,0,0,0,0,0,0,0,0,0,0,0,0,0,0,0,0,0,0,0,0,0,0,0,1,2,1,0,0,0,0,0,0,0,0,0,3,6,10,8,7,4,6,5,6,7,7,10,11,5,0,0
0,0,0,0,0,0,0,0,0,0,0,0,0,0,0,0,0,0,0,0,0,0,0,0,0,0,0,0,0,0,0,0,0,0,0,0,0,0,0,0,0,0,0,0,0,0,8,13,8,0,0,0,0,0,0,0,0,0,0,0,0,0,0,0,0,0,0,0,0,0,0,0,1,2,1,0,0,0,0,0,0,0,0,0,3,7,11,9,7,6,6,4,5,6,7,11,11,5,0,0
0,0,0,0,0,0,0,0,0,0,0,0,1,1,0,0,0,0,0,0,0,0,0,0,0,0,0,0,0,0,0,0,0,0,0,0,0,0,0,0,0,0,0,0,0,0,12,19,12,0,0,0,0,0,0,0,0,0,0,0,1,1,2,2,2,2,2,2,2,1,0,0,1,1,1,0,1,0,0,0,0,0,0,0,3,8,11,8,7,8,11,14,17,22,29,64,76,38,0,0
0,0,0,0,0,0,0,0,0,0,0,1,2,4,5,3,1,1,0,0,0,0,0,0,0,0,0,0,0,0,0,0,0,0,0,0,0,0,0,0,0,0,0,0,0,0,10,16,9,0,0,0,0,0,0,0,0,1,1,2,3,3,4,4,3,3,3,3,3,3,3,3,3,2,0,0,1,1,0,0,0,0,0,0,2,9,12,10,12,20,25,26,24,31,40,95,101,62,0,0
0,0,0,0,0,0,0,3,5,5,3,1,2,4,6,5,3,2,1,1,1,1,1,0,0,0,0,0,0,0,0,0,0,0,0,0,0,0,0,0,0,0,0,0,0,1,8,11,6,0,0,0,0,0,0,1,3,4,6,7,6,6,6,6,4,4,3,3,3,3,4,4,4,3,2,1,1,1,1,0,0,0,0,0,1,9,16,18,22,30,30,23,17,17,24,55,67,34,0,0
0,0,0,0,0,0,1,4,8,8,5,2,3,4,6,4,2,1,2,2,2,3,3,2,1,1,1,1,0,0,1,1,1,1,1,1,1,1,1,1,1,2,4,4,4,4,9,11,7,1,0,0,1,4,5,7,7,7,7,8,6,5,6,6,5,4,4,5,4,3,3,4,4,5,4,3,4,3,1,0,0,0,0,1,5,13,20,24,28,27,19,7,2,0,0,0,0,0,0,0
0,0,0,0,0,0,0,3,5,5,3,2,4,4,4,3,2,1,2,3,2,2,2,2,2,2,2,1,0,0,1,2,2,2,2,2,2,2,2,3,4,5,7,7,5,4,9,15,16,10,7,7,7,10,10,9,7,5,4,4,3,3,4,5,5,4,4,5,5,4,3,3,4,4,4,4,5,6,4,0,0,0,1,5,10,17,23,25,23,15,5,0,0,0,0,0,0,0,0,0
0,0,0,0,0,0,0,0,0,0,0,1,2,3,3,3,2,2,2,2,2,2,3,3,3,3,3,2,0,0,1,1,1,1,1,1,3,4,5,5,6,6,7,6,4,3,7,15,21,19,15,12,10,9,8,6,4,3,2,1,0,0,0,1,1,1,1,2,3,3,3,4,5,5,4,3,5,7,6,4,3,2,5,8,12,18,23,24,17,7,1,0,0,0,0,0,0,0,0,0
0,0,0,0,0,0,0,0,0,0,0,0,0,0,0,1,1,1,1,2,2,3,4,4,3,3,3,2,2,2,1,1,2,3,4,4,5,5,5,4,4,4,3,3,2,2,5,11,18,19,16,13,11,10,9,8,6,6,6,5,4,4,3,2,1,0,0,0,0,1,1,2,5,6,5,3,5,6,7,6,7,9,10,9,11,16,24,23,13,2,0,0,0,0,0,0,0,0,0,0
0,0,0,0,0,0,0,0,0,0,0,0,0,0,0,0,0,0,0,0,1,1,2,2,2,2,1,1,2,4,4,4,4,6,7,6,5,4,3,2,1,1,1,2,3,5,7,10,11,11,8,9,10,12,15,17,15,11,10,9,8,10,10,9,7,4,2,2,1,0,0,0,3,4,4,3,4,5,5,7,11,15,13,9,11,17,21,19,10,1,0,0,0,0,0,0,0,0,0,0
0,0,0,0,0,0,0,0,0,0,0,0,0,0,0,0,0,0,0,0,0,0,0,0,0,0,0,1,5,8,7,5,4,4,4,3,1,0,1,1,1,2,2,2,4,7,10,9,7,4,3,4,6,7,12,16,15,11,10,9,9,9,10,11,10,9,8,8,6,3,1,0,1,2,2,1,2,4,7,8,13,16,12,9,12,18,18,14,6,2,0,0,0,0,0,0,0,0,0,0
0,0,0,0,0,0,0,0,0,0,0,0,0,0,0,0,0,0,0,0,0,0,0,0,0,0,0,2,6,8,6,2,1,0,1,1,2,2,2,2,4,6,7,5,5,8,8,5,2,1,0,0,0,0,2,6,7,5,5,7,6,5,6,6,7,8,9,10,10,9,7,4,3,2,1,0,0,4,8,11,15,16,13,12,15,19,17,11,4,1,0,0,0,0,0,0,0,0,0,0
0,0,0,0,0,0,0,0,0,0,0,0,0,0,0,0,0,0,0,0,0,0,0,0,0,0,0,1,4,5,4,2,2,2,3,3,3,3,2,3,7,9,7,5,4,4,3,1,0,0,0,0,0,0,0,0,0,0,2,4,4,3,2,2,3,4,4,5,8,10,11,8,6,5,3,0,0,3,10,13,16,16,15,15,19,20,16,9,2,1,0,0,0,0,0,0,0,0,0,0
0,0,0,0,0,0,0,0,0,0,0,0,0,0,0,0,0,0,0,0,0,0,0,0,0,0,1,2,1,1,2,3,3,3,3,2,2,1,1,3,5,7,5,3,2,2,0,0,0,0,0,0,0,0,0,0,0,0,0,0,1,2,2,2,3,3,3,2,3,6,8,9,11,10,7,3,2,6,11,11,13,14,15,16,21,22,15,7,2,1,0,0,0,0,0,0,0,0,0,0
0,0,0,0,0,0,0,0,0,0,0,0,0,0,0,0,0,0,0,0,0,0,0,0,2,4,4,3,3,2,2,2,2,2,1,0,0,0,0,2,5,6,4,3,1,0,0,0,0,0,0,0,0,0,0,0,0,0,0,0,0,0,0,1,2,3,4,4,3,2,3,5,11,14,12,7,6,11,13,8,6,10,11,14,21,23,15,6,1,0,0,0,0,0,0,0,0,0,0,0
0,0,0,0,0,0,0,0,0,0,0,0,0,0,0,0,0,0,0,0,2,5,5,3,4,5,4,2,1,1,0,0,0,0,0,0,0,2,4,5,5,5,4,2,0,0,0,0,0,0,0,0,0,0,0,0,0,0,0,0,0,0,0,0,0,1,2,3,3,3,2,3,7,10,10,9,11,14,12,5,1,6,9,14,21,23,15,6,1,0,0,0,0,0,0,0,0,0,0,0
0,0,0,0,0,0,0,0,0,0,0,0,0,0,0,0,0,0,0,0,4,9,9,4,3,3,1,0,0,0,0,0,0,0,0,0,2,7,8,7,5,4,1,0,0,0,0,0,0,0,0,0,0,0,0,0,0,0,0,0,0,0,0,0,0,0,0,0,1,2,3,3,4,6,7,10,13,15,11,5,1,5,9,14,20,23,16,6,3,1,0,0,0,0,0,0,0,0,0,0
0,0,0,0,0,0,0,0,0,0,0,0,0,0,0,0,0,0,0,0,3,7,6,2,0,0,0,0,0,0,0,0,0,0,0,0,4,7,7,3,2,0,0,0,0,0,0,0,0,0,0,0,0,0,0,0,0,0,0,0,0,0,0,0,0,0,0,0,0,0,1,2,3,5,6,10,15,14,10,7,5,7,11,12,20,23,18,7,4,2,1,0,0,0,0,0,0,0,0,0
0,0,0,0,0,0,0,0,0,0,0,0,0,0,0,0,0,0,0,0,0,1,0,0,0,0,0,0,0,0,0,0,0,0,0,0,2,3,2,0,0,0,0,0,0,0,0,0,0,0,0,0,0,0,0,0,0,0,0,0,0,0,0,0,0,0,0,0,0,0,0,0,2,4,7,11,14,12,9,7,8,8,11,13,19,24,21,9,3,3,2,1,0,0,0,0,0,0,0,0
0,0,0,0,0,0,0,0,0,0,0,0,0,0,0,0,0,0,0,0,0,0,0,0,0,0,0,0,0,0,0,0,0,0,0,0,0,0,0,0,0,0,0,0,0,0,0,0,0,0,0,0,0,0,0,0,0,0,0,0,0,0,0,0,0,0,0,0,0,0,0,0,0,2,7,11,13,12,9,6,8,10,12,15,21,26,21,10,2,1,2,1,0,0,0,0,0,0,0,0
0,0,0,0,0,0,0,0,0,0,0,0,0,0,0,0,0,0,0,0,0,0,0,0,0,0,0,0,0,0,0,0,0,0,0,0,0,0,0,0,0,0,0,0,0,0,0,0,0,0,0,0,0,0,0,0,0,0,0,0,0,0,0,0,0,0,0,0,0,0,0,0,0,1,6,10,10,10,10,8,7,10,12,19,23,23,16,9,2,0,1,2,1,0,0,0,0,0,0,0
0,0,0,0,0,0,0,0,0,0,0,0,0,0,0,0,0,0,0,0,0,0,0,0,0,0,0,0,0,0,0,0,0,0,0,0,0,0,0,0,0,0,0,0,0,0,0,0,0,0,0,0,0,0,0,0,0,0,0,0,0,0,0,0,0,0,0,0,0,0,0,0,0,2,7,9,7,7,10,13,11,11,12,22,25,20,11,9,4,0,1,2,2,1,0,0,0,0,0,0
0,0,0,0,0,0,0,0,0,0,0,0,0,0,0,0,0,0,0,0,0,0,0,0,0,0,0,0,0,0,0,0,0,0,0,0,0,0,0,0,0,0,0,0,0,0,0,0,0,0,0,0,0,0,0,0,0,0,0,0,0,0,0,0,0,0,0,0,0,0,0,0,0,3,7,9,5,3,7,15,17,12,11,20,24,20,10,8,4,2,0,1,2,2,0,0,0,0,0,0
0,0,0,0,0,0,0,0,0,0,0,0,0,0,0,0,0,0,0,0,0,0,0,0,0,0,0,0,0,0,0,0,0,0,0,0,0,0,0,0,0,0,0,0,0,0,0,0,0,0,0,0,0,0,0,0,0,0,0,0,0,0,0,0,0,0,0,0,0,0,0,0,0,4,10,11,6,2,3,14,21,18,12,16,21,19,13,8,4,2,1,0,2,2,2,0,0,0,0,0
0,0,0,0,0,0,0,0,0,0,0,0,0,0,0,0,0,0,0,0,0,0,0,0,0,0,0,0,0,0,0,0,0,0,0,0,0,0,0,0,0,0,0,0,0,0,0,0,0,0,0,0,0,0,0,0,0,0,0,0,0,0,0,0,0,0,0,0,0,0,0,0,0,6,13,13,6,2,1,9,19,21,16,15,17,18,14,7,3,2,1,0,0,2,2,1,0,0,0,0
0,0,0,0,0,0,0,0,0,0,0,0,0,0,0,0,0,0,0,0,0,0,0,0,0,0,0,0,0,0,0,0,0,0,0,0,0,0,0,0,0,0,0,0,0,0,0,0,0,0,0,0,0,0,0,1,4,3,1,0,0,0,0,0,0,0,0,0,0,0,0,0,0,8,16,14,5,1,2,8,16,18,19,16,18,18,16,8,3,1,2,1,0,1,2,1,0,0,0,0
0,0,0,0,0,0,0,0,0,0,0,0,0,0,0,0,0,0,0,0,0,0,0,0,0,0,0,0,0,0,0,0,0,0,0,0,0,0,0,0,0,0,0,0,0,0,0,0,0,0,0,0,0,0,0,2,7,8,3,0,0,0,0,0,0,0,0,0,0,0,0,0,0,8,15,13,4,1,4,10,13,13,18,18,20,21,19,9,4,1,2,2,0,0,1,2,1,0,0,0
0,0,0,0,0,0,0,0,0,0,0,0,0,0,0,0,0,0,0,0,0,0,0,0,0,0,0,0,0,0,0,0,0,0,0,0,0,0,0,0,0,0,0,0,0,0,0,0,0,0,0,0,0,0,0,1,6,8,5,0,0,0,0,0,0,0,0,0,0,0,0,0,0,6,13,11,4,1,6,11,13,11,16,18,22,24,21,11,5,2,2,3,1,0,1,2,2,1,0,0
0,0,0,0,0,0,0,2,6,6,2,0,0,0,0,0,0,0,0,0,0,0,0,0,0,0,0,0,0,0,0,0,0,0,0,0,0,0,0,0,0,0,0,0,0,0,0,0,0,0,0,0,1,1,0,0,1,4,4,3,1,0,0,0,0,0,0,0,0,0,0,0,0,6,13,11,4,1,6,11,13,13,17,19,23,23,19,12,6,2,1,2,2,0,0,2,2,1,0,0
0,0,0,0,0,0,0,3,9,10,5,0,0,0,0,0,0,0,0,0,0,0,0,0,0,0,0,0,0,0,0,0,0,0,0,0,0,0,0,2,4,5,3,1,0,0,0,0,0,0,0,0,4,5,3,0,0,0,4,5,3,0,0,0,0,0,0,0,0,0,0,0,0,6,13,12,4,1,8,11,12,14,17,19,22,22,17,12,8,3,1,1,2,1,0,1,3,1,0,0
0,0,0,0,0,0,0,1,5,9,12,12,6,0,0,0,0,0,0,0,0,0,0,0,0,0,0,0,0,0,0,0,0,0,0,0,0,0,1,4,7,8,5,2,0,0,0,0,0,0,0,0,5,8,6,0,0,0,3,6,5,0,0,0,0,0,0,0,0,0,0,0,0,4,14,15,6,1,8,11,13,16,16,17,21,20,15,13,10,6,2,2,3,1,0,2,3,2,0,0
0,0,0,0,0,0,0,0,0,7,19,22,13,3,0,0,0,0,0,0,0,0,0,0,0,0,0,0,0,0,0,0,0,0,0,0,1,2,2,3,5,5,3,1,0,0,0,0,0,0,0,0,3,6,5,1,0,0,1,4,4,1,0,0,0,0,0,0,0,0,0,0,0,3,18,24,13,2,7,12,20,23,24,23,24,20,19,17,13,10,8,9,8,6,5,8,8,4,0,0
0,0,0,0,1,4,4,1,2,12,19,21,13,6,0,0,0,0,0,0,0,0,0,1,1,2,2,0,0,0,0,0,0,0,1,2,3,3,2,1,0,0,0,0,0,0,0,0,0,0,0,0,0,2,3,2,0,0,0,3,4,2,0,0,0,0,0,0,0,0,0,0,0,3,20,27,20,7,9,15,29,37,37,32,27,24,26,29,25,24,22,17,12,9,8,11,10,5,0,0
0,0,0,0,2,7,8,4,10,19,17,8,8,7,2,0,0,0,2,3,2,1,2,2,3,4,3,2,1,2,3,3,2,2,3,3,3,2,0,0,0,0,0,0,0,0,0,0,0,0,0,0,0,0,2,3,3,1,0,2,4,2,0,0,0,0,0,0,0,0,0,0,0,2,14,22,19,14,17,24,40,50,49,41,33,32,40,42,39,34,30,19,11,8,6,11,14,7,0,0
0,0,0,0,1,5,7,5,14,19,13,1,7,10,6,0,2,5,6,5,3,2,2,2,2,2,2,2,2,4,7,8,7,4,3,2,1,0,0,0,0,0,0,0,0,0,0,0,0,0,0,0,0,0,0,3,4,3,0,2,4,5,3,1,0,0,0,0,0,0,0,0,0,2,9,14,16,20,26,34,43,51,48,43,35,32,36,43,38,29,22,17,11,6,2,12,20,12,0,0
0,0,0,0,0,0,2,3,9,12,7,3,11,17,15,11,16,14,7,4,2,1,1,1,2,3,3,4,4,5,6,8,7,4,1,0,0,0,0,0,0,0,0,0,0,0,0,0,0,0,0,0,0,0,0,1,4,3,1,0,3,9,10,5,0,0,0,0,0,0,0,0,6,21,36,45,51,66,69,56,43,41,37,41,44,51,72,93,86,61,52,66,73,54,24,39,54,29,0,0
0,0,0,0,0,0,0,1,4,7,7,7,11,17,18,24,25,20,7,1,1,2,3,3,4,4,4,4,4,3,2,3,3,1,0,0,0,0,0,0,0,0,0,0,0,0,0,0,0,0,0,0,0,0,0,0,2,3,2,0,3,11,13,6,0,0,0,0,0,0,0,0,11,31,50,59,68,97,107,87,50,35,33,44,54,60,87,114,109,81,72,91,104,77,40,49,59,34,0,0
0,0,0,0,0,0,0,0,6,12,11,7,5,7,13,21,25,17,8,4,4,5,5,4,3,3,3,3,4,3,0,0,0,0,0,0,0,0,0,0,0,0,0,0,0,0,0,0,0,0,0,0,0,0,0,0,1,2,2,1,3,8,9,5,0,0,0,0,0,0,0,0,6,19,29,34,39,77,113,103,63,40,39,55,61,50,52,68,65,49,42,54,63,47,23,26,34,17,0,0
0,0,0,0,0,0,0,0,8,17,19,10,2,0,3,13,17,14,8,9,8,8,6,5,3,3,5,6,4,1,0,0,0,0,0,0,0,0,0,0,0,0,0,0,0,0,0,0,0,0,0,0,0,0,0,0,0,1,2,1,2,5,7,5,2,0,0,0,0,0,0,0,0,0,0,0,0,31,72,90,65,46,40,59,53,25,0,0,0,0,0,0,0,0,0,0,0,0,0,0
0,0,0,0,0,0,0,0,6,14,18,11,4,8,15,21,22,18,11,12,12,7,5,5,4,5,8,8,4,0,0,0,0,0,0,0,0,0,0,0,0,0,0,0,0,0,0,0,0,0,0,0,0,0,0,0,0,0,1,1,2,3,6,7,4,0,0,0,0,0,0,0,0,0,0,0,0,18,47,65,60,51,39,46,42,21,0,0,0,0,0,0,0,0,0,0,0,0,0,0
0,0,0,0,0,0,0,0,2,5,8,7,2,17,27,29,21,17,11,12,12,6,3,3,3,3,5,5,2,0,0,0,0,0,0,0,0,0,0,0,0,0,0,0,0,0,0,0,0,0,0,0,0,0,0,0,0,0,0,2,2,3,5,6,4,1,0,0,0,0,0,0,0,0,0,0,2,19,42,55,54,52,45,40,31,14,0,0,0,0,0,0,0,0,0,0,0,0,0,0
0,0,0,0,0,0,0,0,0,0,0,0,0,13,24,22,14,13,10,15,15,7,0,0,0,0,0,0,0,0,0,0,0,0,0,0,0,0,0,0,0,0,0,0,0,0,0,0,0,0,0,0,0,0,0,0,0,0,0,1,3,4,4,6,6,7,19,26,13,0,0,0,0,0,0,1,5,25,49,52,44,46,46,41,29,16,3,0,0,0,0,0,0,0,0,0,0,0,0,0
0,0,0,0,0,0,0,0,0,0,0,0,0,3,9,10,9,9,10,18,18,10,0,0,0,0,0,0,0,0,0,0,0,0,0,0,0,0,0,0,0,0,0,0,0,0,0,0,0,0,0,0,0,0,0,0,0,0,0,0,2,4,4,6,8,11,43,56,33,0,0,0,0,0,2,2,5,20,36,40,35,38,44,38,29,19,10,1,0,0,0,0,0,0,0,0,0,0,0,0
0,0,0,0,0,0,0,0,0,0,0,0,0,0,4,7,9,9,12,17,16,7,0,0,0,0,0,0,0,0,0,0,0,0,0,0,0,1,0,0,0,0,0,0,0,0,0,0,0,0,0,0,0,0,0,0,0,0,0,0,2,3,5,7,11,13,48,64,38,0,0,0,0,2,4,3,4,9,17,26,32,33,39,39,30,21,14,4,0,0,0,0,0,0,0,0,0,0,0,0
0,0,0,0,0,0,0,0,0,0,0,0,0,0,1,5,7,10,11,14,12,6,0,0,0,0,0,0,0,0,0,0,0,0,0,0,2,5,5,2,0,0,0,0,0,8,13,8,0,0,0,0,0,0,0,0,0,0,0,0,1,3,5,7,14,20,39,43,23,0,0,0,0,3,5,4,4,6,11,21,31,30,35,37,33,21,15,6,1,0,0,0,0,0,0,0,0,0,0,0
0,0,0,0,0,0,0,0,0,0,0,0,0,0,0,1,4,9,11,13,13,10,2,0,0,0,0,0,0,0,0,0,0,0,0,0,2,7,8,5,0,0,0,1,0,19,29,19,0,0,0,0,0,0,0,0,0,0,0,0,0,2,4,7,20,34,39,27,9,0,0,0,1,6,9,7,5,5,10,22,35,30,28,31,33,24,15,8,3,0,0,0,0,0,0,0,0,0,0,0
0,0,0,0,0,0,0,0,0,0,0,0,0,0,0,0,1,6,9,12,13,11,6,3,0,0,0,0,0,3,3,1,0,0,0,0,0,4,7,6,2,0,2,4,3,22,35,21,0,0,0,0,0,0,0,0,0,0,0,0,0,1,4,10,24,39,43,31,21,20,24,25,25,22,21,14,8,4,8,21,33,32,25,25,31,27,18,10,5,0,0,0,0,0,0,0,0,0,0,0
0,0,0,0,0,0,0,0,0,0,0,0,0,0,0,0,0,3,7,10,11,12,9,7,4,1,0,0,1,4,7,6,2,0,0,0,0,0,3,5,5,3,6,9,7,26,40,24,0,0,0,0,0,0,0,0,0,0,0,0,0,2,10,23,33,43,54,50,45,41,44,42,39,36,33,27,14,5,6,18,30,36,31,28,28,27,21,16,8,1,0,0,0,0,0,0,0,0,0,0
0,0,0,0,0,0,0,0,0,0,0,0,0,0,0,0,0,2,4,7,9,12,12,11,10,7,5,3,3,4,8,8,6,4,5,5,4,3,4,5,6,4,7,10,7,34,51,32,0,0,0,0,0,0,0,0,0,4,7,6,4,6,19,30,34,44,58,63,50,42,33,29,26,26,31,33,24,8,6,15,28,36,36,27,23,24,22,18,11,5,1,0,0,0,0,0,0,0,0,0
0,0,0,0,0,0,0,0,0,0,0,0,0,0,0,0,0,3,6,8,11,12,11,10,13,13,12,8,5,3,4,6,6,6,8,8,7,7,7,6,6,8,12,13,9,47,71,43,0,0,0,0,0,0,0,1,3,8,12,12,10,15,23,28,27,41,51,52,41,29,17,14,18,24,33,42,37,19,9,15,25,34,35,25,18,21,22,19,14,9,4,1,0,0,0,0,0,0,0,0
0,0,0,0,0,0,0,0,0,0,0,0,0,0,0,0,0,3,6,9,10,11,8,6,8,11,12,11,9,6,3,1,2,4,5,5,4,6,6,5,6,12,17,16,11,58,84,52,0,0,0,0,0,0,0,3,6,8,10,11,11,21,29,25,21,32,42,44,42,41,41,41,38,34,37,56,64,45,25,27,32,35,34,26,17,20,24,19,15,12,8,3,0,0,0,0,0,0,0,0
0,0,0,0,0,0,0,0,0,0,0,0,0,0,0,0,0,2,5,7,6,6,4,2,2,4,6,8,10,8,7,6,4,2,1,0,0,1,2,1,6,13,18,16,11,55,81,50,0,0,0,0,0,0,2,5,6,5,5,9,13,25,30,27,21,33,50,62,67,66,69,79,84,70,56,66,74,61,38,44,54,56,55,49,31,22,25,21,16,14,11,4,0,0,0,0,0,0,0,0
0,0,0,0,0,0,0,0,0,0,0,0,0,0,0,0,0,1,3,3,1,2,4,3,1,0,1,4,6,7,8,9,9,7,6,5,2,1,2,1,5,10,13,12,10,51,78,46,0,0,0,0,1,3,4,6,7,8,9,11,17,26,33,29,26,39,70,92,88,76,77,91,95,82,66,64,69,57,42,46,67,78,79,70,51,30,24,21,18,16,12,6,0,0,0,0,0,0,0,0
0,0,0,0,0,0,0,0,0,0,0,0,0,0,0,0,0,0,2,3,1,0,2,3,3,0,1,3,6,6,6,8,11,11,12,12,11,8,7,7,11,16,20,17,12,52,74,46,0,0,0,1,5,8,10,11,13,14,16,21,30,36,37,31,30,45,89,107,83,50,52,58,63,56,54,51,53,47,35,29,52,74,84,76,62,39,25,25,26,20,13,9,3,0,0,0,0,0,0,0
0,0,0,0,0,0,0,0,0,0,0,0,0,0,0,0,0,0,1,3,3,0,0,2,3,3,3,6,8,7,4,3,6,8,10,12,13,12,11,13,17,23,27,26,20,48,69,50,17,16,14,13,13,13,12,12,13,15,22,29,34,39,40,39,37,47,93,103,60,14,19,21,15,14,24,33,42,47,38,19,25,53,73,73,61,45,27,26,33,31,19,10,5,0,0,0,0,0,0,0
0,0,0,0,0,0,0,0,0,0,0,0,0,0,0,0,0,0,0,3,3,2,0,0,2,3,5,6,6,4,2,1,2,3,3,5,7,8,8,10,15,20,25,26,24,39,53,47,29,29,26,25,21,20,18,18,19,20,26,32,31,29,34,39,36,38,87,104,54,0,2,9,14,15,14,19,34,48,45,29,21,42,70,78,68,48,32,31,49,46,27,9,5,7,10,9,4,1,0,0
0,0,0,0,0,0,0,0,0,0,0,0,0,0,0,0,0,0,0,1,3,3,1,0,0,2,3,3,3,1,0,0,0,0,0,0,0,1,2,3,8,13,14,16,23,36,42,38,28,24,21,20,22,24,25,27,28,27,28,26,21,21,30,37,35,33,82,97,54,0,2,9,15,17,17,24,43,58,60,51,40,45,64,80,79,61,42,47,71,68,42,23,27,36,33,24,13,5,0,0
0,0,0,0,0,0,0,1,4,5,4,2,1,2,1,0,0,0,0,0,1,3,3,1,0,0,1,3,3,3,2,2,1,0,0,0,0,1,2,2,6,10,10,10,20,32,33,24,17,14,15,17,21,25,27,28,28,27,22,17,16,27,41,37,29,27,73,89,48,0,2,7,10,13,20,36,56,64,64,65,60,58,62,82,100,91,60,64,80,79,55,42,45,54,49,36,20,7,0,0
0,0,0,0,0,0,0,2,6,9,7,3,3,3,3,2,2,2,1,0,1,4,5,4,1,0,0,2,5,5,5,6,6,6,6,6,5,5,6,7,10,14,15,13,21,32,35,28,23,20,21,26,24,21,18,18,15,14,11,7,16,37,47,39,23,21,63,79,44,0,3,5,4,6,19,42,60,64,59,58,59,62,64,85,110,107,79,66,69,69,56,41,39,44,46,34,21,6,0,0
0,0,0,0,0,0,0,1,4,5,4,2,1,2,3,3,3,3,2,1,2,3,5,6,5,5,7,8,7,6,6,8,9,9,10,10,8,7,8,10,12,19,24,22,21,27,31,32,31,31,34,32,26,17,13,11,9,7,6,7,21,36,41,29,17,13,52,70,40,0,4,11,11,6,11,32,53,56,48,41,43,50,54,77,102,108,87,70,58,53,45,29,18,23,33,41,32,11,0,0
0,0,0,0,0,0,0,0,0,0,0,0,0,0,1,2,2,2,1,0,1,2,2,4,6,9,11,12,8,5,5,6,6,6,6,6,5,4,6,7,8,17,23,23,17,19,31,42,39,30,29,24,17,10,8,6,5,4,5,8,19,27,24,17,13,10,45,64,36,0,7,25,37,31,25,40,53,62,69,81,79,54,37,60,86,97,90,79,58,55,55,47,33,30,49,74,65,28,0,0
0,0,0,0,0,0,0,0,0,0,0,0,0,0,0,0,0,0,0,0,0,0,0,1,3,6,9,9,5,2,1,2,1,0,0,0,0,1,2,4,4,7,11,11,11,20,39,41,29,15,15,11,6,4,3,1,1,2,3,5,13,17,14,10,10,10,37,50,29,0,27,74,89,70,53,48,61,98,136,147,127,109,88,87,96,103,101,97,98,106,123,117,84,70,84,111,94,43,0,0
0,0,0,0,0,0,0,0,0,0,0,0,0,0,0,0,0,0,0,0,0,0,0,0,0,1,2,3,3,2,1,0,0,0,0,0,0,1,4,5,3,1,1,0,7,31,50,38,9,0,0,0,0,0,0,0,0,0,2,4,9,13,10,6,7,12,29,37,18,0,42,91,107,72,51,49,74,119,145,140,119,123,133,142,131,112,102,106,122,134,155,148,112,85,83,101,83,41,0,0
0,0,0,0,0,0,0,0,0,0,0,0,0,0,0,0,0,0,0,0,0,0,0,0,0,0,0,1,2,3,3,2,1,0,0,1,3,7,9,8,5,2,1,0,7,42,57,31,0,0,0,0,0,0,0,0,0,1,3,4,6,8,9,8,10,18,30,27,11,0,28,68,70,40,28,51,71,88,84,65,53,81,120,155,164,129,87,88,101,105,112,110,86,56,44,58,59,32,0,0
0,0,0,0,0,0,0,0,0,0,0,0,0,0,0,0,0,0,0,0,0,0,0,0,0,0,1,1,2,3,4,3,3,3,4,4,6,8,9,7,4,3,3,4,7,38,51,30,0,0,0,0,0,0,0,2,4,4,3,2,2,5,8,8,9,17,27,23,8,0,10,27,29,14,35,71,73,41,23,21,31,45,61,112,154,142,91,74,76,62,58,65,54,30,16,37,45,26,0,0
0,0,0,0,0,0,0,0,0,0,0,0,0,1,2,3,4,3,1,1,1,1,1,1,1,1,2,2,2,2,2,3,3,4,5,5,5,6,5,4,4,4,5,7,7,21,28,16,0,0,0,0,0,0,1,7,8,5,1,0,0,2,6,8,7,12,17,12,3,0,30,63,64,57,185,268,189,61,43,35,41,47,46,65,127,152,122,93,115,155,186,197,182,148,113,176,200,102,0,0
0,0,0,0,0,0,0,0,0,0,0,0,0,2,4,6,6,5,2,1,2,2,2,2,2,2,1,1,1,1,1,0,1,2,3,2,2,3,3,3,3,3,4,6,6,7,6,3,0,0,0,0,0,0,2,7,8,3,0,0,0,1,3,4,4,7,8,5,0,0,43,74,83,81,260,337,251,77,52,1182,2046,1198,45,44,100,150,150,156,191,221,241,261,242,209,166,258,261,153,0,0
0,0,0,0,0,0,0,0,0,0,0,0,0,1,2,3,4,3,1,1,1,1,1,1,1,1,0,0,0,0,0,0,0,0,0,0,0,1,1,1,2,2,2,2,2,1,1,0,0,0,0,0,0,0,1,3,3,0,0,0,0,0,1,2,3,4,4,2,0,0,23,46,46,48,145,206,138,45,29,2020,2892,2051,52,44,91,138,150,166,173,162,142,150,142,124,99,149,170,84,0,0
0,0,0,0,0,0,0,0,0,0,0,0,0,0,0,0,0,0,0,0,0,0,0,0,0,0,0,0,0,0,0,0,0,0,0,0,0,0,0,0,0,0,0,0,0,0,0,0,0,0,0,0,0,0,0,0,0,0,0,0,0,0,0,0,0,0,0,0,0,0,0,0,0,0,0,0,0,0,0,1141,2014,1179,43,43,80,105,106,102,87,32,0,0,0,0,0,0,0,0,0,0
0,0,0,0,0,0,0,0,0,0,0,0,0,0,0,0,0,0,0,0,0,0,0,0,0,0,0,0,0,0,0,0,0,0,0,0,0,0,0,0,0,0,0,0,0,0,0,0,0,0,0,0,0,0,0,0,0,0,0,0,0,0,0,0,0,0,0,0,0,0,0,0,0,0,0,0,0,0,0,0,5,12,19,29,49,58,45,24,9,0,0,0,0,0,0,0,0,0,0,0
