0,0,0,0,0,0,0,0,0,0,0,0,0,0,0,0,0,0,0,0,0,0,0,0,0,0,0,0,0,0,0,0,0,0,0,0,0,0,0,0,0,0,0,0,0,0,0,0,0,0,0,0,0,0,0,0,0,0,0,0,0,0,0,0,0,0,0,0,0,0,0,0,0,0,0,0,0,0,0,0,0,0,0,0,0,0,0,0,0,0,0,0,0,0,0,0,0,0,0,0
0,0,0,0,0,0,0,0,0,0,0,0,0,0,0,0,0,0,0,0,0,0,0,0,0,0,0,0,0,0,0,0,0,0,0,0,0,0,0,0,0,0,0,0,0,0,0,0,1,2,5,13,19,22,19,13,9,9,12,25,38,30,15,17,21,21,54,74,38,0,0,0,0,0,0,0,0,0,0,0,0,0,0,0,0,0,0,0,0,0,0,0,0,0,0,0,0,0,0,0
0,0,0,0,0,0,0,0,0,0,0,0,0,0,0,0,0,0,0,0,0,0,0,0,0,0,0,0,0,0,0,0,0,0,0,0,0,0,0,0,0,0,0,0,0,0,0,3,6,6,9,22,31,39,35,28,18,18,26,50,66,55,33,36,42,45,108,128,75,0,0,0,0,0,0,0,0,0,0,0,0,0,0,0,0,0,0,0,0,0,0,0,0,0,0,0,0,0,0,0
0,0,0,0,0,0,0,0,0,0,0,0,0,0,0,0,0,0,0,0,0,0,0,0,0,0,0,0,0,0,0,0,0,0,0,0,0,0,0,0,0,0,0,0,0,0,0,7,11,10,8,15,20,29,31,25,15,16,25,41,56,45,32,36,40,43,102,129,64,0,0,0,0,0,0,0,0,0,0,0,0,0,0,0,0,0,0,0,0,0,0,0,0,0,0,0,0,0,0,0
0,0,0,0,0,0,0,0,0,0,0,4,8,7,5,3,2,0,0,0,0,0,0,0,0,0,0,0,0,0,0,0,0,0,0,0,0,0,0,0,0,0,0,0,0,0,3,11,12,10,5,3,1,7,12,11,6,7,13,19,20,18,19,21,21,28,75,85,42,0,0,0,0,0,0,0,0,0,0,0,0,0,0,0,0,0,0,0,0,0,0,0,0,0,0,0,0,0,0,0
0,0,0,0,0,0,0,0,0,0,1,7,12,12,8,6,4,3,3,2,1,1,0,1,1,0,0,0,0,0,0,0,0,0,0,0,0,0,0,0,0,0,0,0,0,3,9,12,9,6,6,5,4,5,7,6,4,6,10,15,17,15,16,17,18,36,89,98,48,0,0,1,4,6,4,1,1,2,1,0,0,0,0,0,0,0,0,0,0,0,0,0,0,0,0,0,0,0,0,0
0,0,0,0,0,0,0,0,0,0,0,4,8,7,5,3,3,4,4,4,3,1,1,2,3,2,2,2,0,0,0,0,0,0,0,0,0,0,0,0,0,0,0,0,0,3,9,11,7,5,7,7,7,4,4,4,7,12,16,15,14,18,25,23,36,74,128,120,55,0,0,3,8,12,10,7,5,6,6,3,0,0,0,0,0,0,0,0,0,0,0,0,0,0,0,0,0,0,0,0
0,0,0,0,0,0,0,1,1,0,0,0,0,0,0,0,0,2,3,2,1,1,0,1,2,3,4,4,3,1,0,0,0,0,0,0,0,0,0,0,0,0,0,0,0,1,4,5,6,7,9,13,14,12,14,18,22,27,29,23,20,30,37,33,62,114,165,127,55,0,0,2,7,11,13,11,10,10,10,9,5,1,0,0,0,0,0,0,0,0,0,0,0,0,0,0,0,0,0,0
0,0,0,0,0,0,0,5,10,7,1,0,0,0,0,0,0,0,0,0,0,0,0,0,0,1,2,3,3,3,2,0,0,0,0,0,0,0,0,0,0,0,0,0,0,0,5,8,7,5,7,14,21,25,30,36,45,54,50,34,26,36,45,41,67,121,148,108,55,24,15,7,5,6,11,14,12,10,11,13,11,6,1,0,0,0,0,0,0,0,0,0,0,0,0,0,0,0,0,0
0,0,0,0,0,0,0,8,13,12,5,2,0,0,0,0,0,0,0,0,0,0,0,0,0,0,0,0,2,3,3,3,2,0,0,0,0,0,0,0,0,0,0,0,0,1,9,13,11,5,7,13,25,34,45,54,56,57,52,38,24,35,52,61,73,97,96,70,57,50,36,21,17,9,11,13,11,8,9,19,29,25,9,0,0,0,0,0,0,0,0,0,0,0,0,0,0,0,0,0
0,0,0,0,0,0,0,4,8,8,5,4,3,2,1,0,0,0,0,0,0,0,0,0,0,0,0,0,0,1,3,4,4,2,0,0,0,0,0,0,1,0,0,0,0,1,8,15,17,13,12,16,24,31,42,48,45,38,35,27,21,37,64,82,82,78,62,53,60,65,48,47,42,21,11,14,10,5,7,21,42,46,23,3,0,0,0,0,0,0,0,0,0,0,0,0,0,0,0,0
0,0,0,0,0,0,0,0,0,1,2,4,4,4,3,2,1,1,1,0,0,0,0,0,0,0,0,0,0,0,0,2,6,9,8,5,3,3,2,7,12,10,4,3,3,5,7,11,15,15,13,18,20,22,27,33,26,19,19,23,30,45,66,82,75,59,47,54,67,68,61,65,57,31,16,18,11,2,5,14,36,45,30,8,0,0,0,0,0,0,0,0,0,0,0,0,0,0,0,0
0,0,0,0,0,0,0,0,0,0,0,0,2,3,3,2,2,2,2,1,1,1,1,0,0,0,0,0,0,0,0,0,5,11,12,8,6,5,4,10,18,20,16,13,10,8,9,9,8,7,6,9,12,14,15,15,15,18,19,25,37,49,55,63,52,38,41,74,100,111,101,98,72,44,32,29,16,7,7,8,18,31,30,15,3,0,0,0,0,0,0,0,0,0,0,0,0,0,0,0
0,0,0,0,0,0,0,0,0,0,0,0,0,0,1,1,1,1,1,2,2,3,3,2,1,0,0,0,0,0,0,0,2,7,9,8,8,9,8,11,18,22,20,17,13,9,7,5,1,0,0,2,8,14,16,13,12,15,17,25,41,47,45,50,43,44,70,107,124,127,122,106,80,62,58,44,25,16,13,12,16,26,32,23,8,0,0,0,0,0,0,0,0,0,0,0,0,0,0,0
0,0,0,0,0,0,0,0,0,0,0,0,0,0,0,0,0,0,0,1,1,1,2,3,3,2,1,0,0,0,0,1,2,3,4,7,8,9,11,14,16,14,12,10,8,6,4,3,2,2,3,4,8,18,23,19,12,13,14,23,43,50,44,44,46,70,115,141,122,102,86,78,67,64,58,43,26,20,17,16,19,27,35,31,16,3,0,0,0,0,0,0,0,0,0,0,0,0,0,0
0,0,0,0,0,0,0,0,0,0,0,0,0,0,0,0,0,0,0,0,0,0,0,1,2,3,3,5,6,5,5,7,7,6,5,6,6,6,10,14,14,8,2,1,2,3,2,2,2,3,6,9,11,19,23,20,13,14,23,37,55,58,53,55,69,106,140,136,88,47,29,27,33,37,32,21,15,12,11,11,15,24,36,36,25,8,0,0,0,0,0,0,0,0,0,0,0,0,0,0
0,0,0,0,0,0,0,0,0,0,0,0,0,0,0,0,0,0,0,0,0,0,0,0,0,1,3,12,21,23,16,11,7,5,3,2,1,0,2,6,5,2,0,0,0,0,0,0,1,2,5,10,13,17,18,15,13,23,42,52,60,59,64,68,97,116,123,91,51,15,5,8,13,13,7,4,4,4,3,4,7,18,30,38,30,16,3,0,0,0,0,0,0,0,0,0,0,0,0,0
0,0,0,0,0,0,0,0,0,0,0,0,0,0,0,0,0,0,0,0,1,1,1,0,0,0,2,15,28,29,19,11,5,2,1,0,0,0,0,0,0,0,0,0,0,0,0,0,0,0,1,5,11,17,19,21,26,38,45,53,56,53,58,67,101,112,101,54,23,0,2,4,4,3,4,3,1,0,0,0,0,8,24,34,33,21,8,0,0,0,0,0,0,0,0,0,0,0,0,0
0,0,0,0,0,0,0,0,0,0,0,0,0,0,0,0,0,0,1,2,2,3,4,2,2,4,4,10,17,16,10,6,4,2,3,2,1,1,2,2,1,1,0,0,0,0,0,0,0,0,0,2,8,18,28,34,36,37,31,35,45,44,39,45,77,97,101,67,28,0,3,5,4,1,3,4,2,0,0,0,0,2,15,27,34,24,12,1,0,0,0,0,0,0,0,0,0,0,0,0
0,0,0,0,0,0,0,0,0,0,0,0,0,0,0,0,2,3,3,3,4,11,15,12,8,7,5,4,3,1,1,2,3,3,4,4,3,3,7,13,15,11,8,7,6,7,7,4,4,5,5,4,6,16,32,39,30,20,16,26,37,35,23,28,53,82,99,73,31,0,2,6,10,9,5,3,3,1,0,0,0,0,7,23,33,29,14,4,0,0,0,0,0,0,0,0,0,0,0,0
0,0,0,0,0,0,0,0,0,0,0,0,0,0,2,4,4,4,3,2,5,13,20,17,10,5,2,0,0,0,0,0,0,2,3,2,1,1,8,17,21,16,13,11,10,12,14,15,14,13,12,11,12,15,27,30,19,7,13,22,30,28,20,22,37,59,73,58,20,0,0,5,15,17,9,2,3,3,0,0,0,0,2,15,30,32,19,11,8,5,0,0,0,0,0,0,0,0,0,0
0,0,0,0,0,0,0,0,0,0,0,0,4,10,10,6,4,2,1,0,2,8,12,10,4,1,0,0,0,0,0,0,0,0,0,0,0,0,3,9,12,9,7,7,8,10,13,17,21,23,19,14,12,10,14,20,18,11,14,21,28,25,18,18,31,50,60,43,13,0,0,3,14,17,8,0,3,4,2,0,0,0,0,10,26,32,22,19,18,12,1,0,0,0,0,0,0,0,0,0
0,0,0,0,0,0,0,0,0,0,0,0,9,14,12,4,1,0,0,0,0,0,0,0,0,0,2,5,5,2,0,0,0,0,0,0,0,0,0,0,0,1,3,4,3,3,5,8,16,19,16,9,6,4,3,10,15,15,15,17,23,25,20,14,20,42,78,76,32,0,0,3,10,11,5,0,2,3,2,0,0,0,0,6,20,27,23,21,20,11,0,0,0,0,0,0,0,0,0,0
0,0,0,0,0,0,0,0,0,0,0,1,6,10,6,0,0,0,0,0,0,0,0,1,2,4,5,8,12,14,10,6,5,4,1,0,1,3,3,3,3,3,5,5,3,1,1,0,4,9,7,1,0,0,3,7,10,15,20,19,19,23,21,13,11,27,82,93,48,0,0,3,8,9,4,0,0,2,3,1,0,0,0,4,15,23,24,22,15,6,0,0,0,0,0,0,0,0,0,0
0,0,0,0,0,0,0,0,0,0,0,0,1,0,0,0,0,0,0,0,0,1,4,6,5,5,5,6,13,18,17,10,8,7,5,4,5,5,5,4,4,3,3,2,1,0,0,0,0,0,0,0,1,5,7,6,3,10,21,26,24,22,15,8,8,19,63,77,40,0,0,3,8,9,3,0,0,2,3,2,0,0,0,4,11,22,27,25,13,4,0,0,0,0,0,0,0,0,0,0
0,0,0,0,0,0,0,0,0,0,0,0,0,0,0,0,0,0,0,0,7,15,13,8,5,3,2,0,4,10,10,6,5,5,5,6,12,18,14,8,6,5,5,4,4,4,3,1,0,1,2,4,10,15,13,7,4,7,15,25,29,27,19,16,14,17,45,56,30,0,0,2,7,7,3,0,0,1,2,2,0,0,0,3,9,21,28,24,12,5,0,0,0,0,0,0,0,0,0,0
0,0,0,0,0,0,0,0,0,0,0,0,0,0,0,0,0,0,0,1,13,19,16,5,1,0,0,0,0,0,0,0,0,0,2,3,14,21,19,8,6,6,8,8,12,15,13,7,5,5,5,7,13,16,12,6,5,5,6,14,25,32,31,25,17,16,55,71,40,0,0,2,6,6,2,0,0,0,2,2,1,0,0,2,12,27,29,23,12,5,0,0,0,0,0,0,0,0,0,0
0,0,0,0,0,0,0,0,0,0,0,0,0,0,0,0,0,0,0,0,7,12,7,0,0,0,0,0,0,0,0,0,0,0,0,0,7,13,11,5,4,4,5,7,13,18,17,10,7,6,5,4,7,8,5,3,3,2,1,3,14,24,26,19,12,12,49,64,37,0,0,2,5,5,1,0,0,0,2,3,2,0,0,2,16,30,32,23,16,6,0,0,0,0,0,0,0,0,0,0
0,0,0,0,0,0,0,0,0,0,0,0,0,0,0,0,0,0,0,0,0,0,0,0,0,0,0,0,0,0,0,0,0,0,0,0,0,0,0,0,0,0,0,1,5,9,8,5,4,2,1,0,0,0,0,0,0,0,0,0,3,7,7,4,3,6,23,30,15,0,0,2,6,5,1,0,0,0,1,2,2,0,0,3,16,28,29,29,26,11,0,0,0,0,0,0,0,0,0,0
0,0,0,0,0,0,0,0,0,0,0,0,0,0,0,0,0,0,0,0,0,0,0,0,0,0,0,0,0,0,0,0,0,0,0,0,0,0,0,0,0,0,0,0,0,0,0,0,0,0,0,0,0,0,0,0,0,0,0,0,0,0,0,0,0,0,0,0,0,0,0,1,5,6,3,0,0,0,0,1,2,1,0,4,12,20,23,35,33,16,0,0,0,0,0,0,0,0,0,0
0,0,0,0,0,0,0,0,0,0,0,0,0,0,0,0,0,0,0,0,0,0,0,0,0,0,0,0,0,0,0,0,0,0,0,0,0,0,0,0,0,0,0,0,0,0,0,0,0,0,0,0,0,0,0,0,0,0,0,0,0,0,0,0,0,0,0,0,0,0,0,0,5,7,4,0,0,0,0,1,2,1,0,4,10,15,18,30,31,14,0,0,0,0,0,0,0,0,0,0
0,0,0,0,0,0,0,0,0,0,0,0,0,0,0,0,0,0,0,0,0,0,0,0,0,0,0,0,0,0,0,0,0,0,0,0,0,0,0,0,0,0,0,0,0,0,0,0,0,0,0,0,0,0,0,0,0,0,0,0,0,0,0,0,0,0,0,0,0,0,0,0,4,7,5,0,0,0,0,1,2,1,1,4,7,11,15,25,25,13,0,0,0,0,0,0,0,0,0,0
0,0,0,0,0,0,0,0,0,0,0,0,0,0,0,0,0,0,0,0,0,0,0,0,0,0,0,0,0,0,0,0,0,0,0,0,0,0,0,0,0,0,0,0,0,0,0,0,0,0,0,0,0,0,0,0,0,0,0,0,0,0,0,0,0,0,0,0,0,0,0,0,2,6,5,1,0,0,0,1,2,1,3,5,5,7,13,24,27,16,7,9,6,0,0,0,0,0,0,0
0,0,0,0,0,0,0,0,0,0,0,5,10,9,5,4,4,3,3,4,3,0,0,0,0,0,0,0,0,0,0,0,0,0,0,0,0,0,0,0,0,0,0,0,0,0,0,0,0,0,0,0,0,0,0,0,0,0,0,0,0,0,0,0,0,0,0,0,0,0,0,0,1,4,5,2,0,0,0,0,2,2,5,5,5,7,12,22,26,17,14,17,12,1,0,0,0,0,0,0
0,0,0,0,0,0,0,0,0,0,1,8,15,15,9,7,7,6,6,7,10,11,9,5,3,0,0,0,0,0,0,0,0,0,0,0,0,0,0,0,0,0,0,0,0,0,0,0,0,0,0,0,0,0,0,0,0,0,0,0,0,0,0,0,0,0,0,0,0,0,0,0,1,4,5,3,0,0,0,0,2,4,6,5,4,7,10,19,23,19,16,17,9,0,0,0,0,0,0,0
0,0,0,0,3,6,5,1,0,0,0,5,10,9,5,4,4,3,3,5,12,16,15,9,6,5,3,1,0,0,0,0,0,0,0,0,0,0,0,0,1,1,2,3,3,9,12,6,0,0,0,0,0,0,0,0,0,0,0,0,0,0,0,0,0,0,0,0,0,0,0,0,0,4,6,3,0,0,0,0,1,6,7,4,2,6,10,17,23,22,13,8,2,0,0,0,0,0,0,0
0,0,0,0,6,12,14,6,1,0,0,0,0,0,0,0,0,0,0,0,5,10,9,6,6,6,6,4,3,2,2,1,0,0,0,0,0,0,1,1,2,3,4,4,4,20,28,18,0,0,0,0,0,0,0,0,0,0,0,0,0,0,0,0,0,0,0,0,0,0,0,0,0,3,6,3,0,0,0,0,1,5,6,3,1,5,8,16,24,23,12,4,0,0,0,0,0,0,0,0
0,0,0,0,3,12,14,11,5,2,0,0,0,0,0,0,0,0,0,0,0,0,0,0,1,3,4,3,4,4,4,3,2,1,1,1,0,1,2,2,1,1,2,3,3,19,31,23,3,0,0,0,0,0,0,1,6,9,8,8,8,4,0,0,0,0,0,0,0,0,0,0,0,3,5,3,0,0,0,0,1,5,6,3,1,3,8,17,25,23,11,2,0,0,0,0,0,0,0,0
0,0,0,0,0,3,8,9,7,5,3,1,0,0,0,0,0,0,0,0,0,0,0,0,0,0,0,1,2,2,3,3,4,4,5,5,9,13,15,12,8,6,5,4,4,13,23,19,7,1,0,0,0,0,1,3,12,18,18,17,14,6,0,0,0,0,0,0,0,0,0,0,0,3,6,4,0,0,0,0,0,4,6,4,1,2,7,18,27,21,9,2,0,0,0,0,0,0,0,0
0,0,0,0,0,0,1,3,4,5,6,10,11,5,0,0,0,0,0,0,0,0,0,0,0,0,0,0,0,0,3,6,9,9,11,12,16,22,22,18,14,12,9,9,8,13,20,20,12,8,7,5,3,4,6,7,13,20,20,19,16,9,4,3,2,1,0,0,0,0,0,0,0,2,5,5,1,0,0,0,0,5,6,3,1,2,6,18,25,19,8,2,0,0,0,0,0,0,0,0
0,0,0,0,0,0,0,0,0,1,5,14,17,13,6,3,1,0,0,0,0,0,0,0,0,0,0,6,17,21,16,14,13,12,11,11,12,14,15,11,9,9,7,7,7,10,16,19,16,13,12,13,11,11,11,10,10,12,13,13,12,10,9,9,6,4,2,1,0,0,0,0,0,1,5,5,1,0,0,0,1,5,5,2,1,2,6,18,24,17,7,3,0,0,0,0,0,0,0,0
0,0,0,0,0,0,0,0,0,0,2,7,12,11,9,8,6,4,2,0,0,0,0,0,0,0,1,15,32,35,25,15,11,7,6,4,3,1,0,0,1,1,1,1,1,3,7,14,18,18,16,19,20,17,15,14,14,13,13,14,13,13,13,13,11,9,7,5,3,2,0,0,0,1,3,4,2,0,0,0,3,6,5,1,1,2,7,19,24,16,8,4,1,0,0,0,0,0,0,0
0,0,0,0,0,0,0,0,0,0,0,0,1,3,5,7,8,7,5,4,4,3,3,3,2,3,6,14,25,24,15,7,2,1,0,0,0,0,0,4,7,5,5,9,9,5,6,14,21,20,16,17,17,14,12,12,12,12,12,11,10,11,12,14,14,15,12,8,8,8,6,3,0,0,3,5,4,1,0,0,9,15,11,2,3,3,8,19,23,15,9,6,1,0,0,0,0,0,0,0
0,0,0,0,0,0,0,0,0,0,0,0,0,0,0,2,4,5,5,6,6,5,4,5,5,7,8,7,4,3,1,0,0,0,0,0,0,0,0,6,13,14,17,21,18,8,10,19,27,26,18,12,7,6,6,6,6,7,7,7,6,7,7,10,12,13,11,11,12,13,12,10,5,2,4,6,5,1,0,0,14,22,16,2,3,3,8,18,22,15,9,6,2,0,0,0,0,0,0,0
0,0,0,0,0,0,0,0,0,0,0,0,0,0,0,0,0,0,1,3,4,3,3,6,7,7,5,2,0,0,0,0,0,0,0,0,0,0,0,4,11,13,26,36,24,6,10,18,23,20,13,6,1,0,0,0,0,0,0,0,1,1,1,3,4,5,6,9,11,12,13,14,12,9,9,10,9,4,2,2,14,21,15,2,3,3,7,17,21,14,7,5,3,2,1,0,0,0,0,0
0,0,0,0,0,0,0,0,0,0,0,0,0,0,0,0,0,0,0,0,0,3,8,9,7,3,0,0,0,0,0,0,0,0,0,0,0,7,11,7,4,8,25,31,22,4,10,17,16,9,6,3,1,1,1,0,0,0,0,0,0,0,0,0,0,0,1,4,6,6,6,11,13,13,14,16,14,9,5,4,12,16,13,5,4,2,7,17,20,13,7,5,3,3,3,2,2,0,0,0
0,0,0,0,0,0,0,0,0,0,0,0,0,0,0,0,0,0,0,0,4,13,15,11,5,1,0,0,0,0,0,0,0,0,0,0,0,11,18,17,7,5,12,19,13,4,19,26,15,0,0,0,1,2,2,2,2,2,2,2,3,3,2,2,2,1,1,2,3,3,4,6,10,12,14,18,18,12,8,7,13,17,13,6,6,5,9,18,21,13,7,5,3,2,2,5,6,3,0,0
0,0,0,0,0,0,0,0,0,0,0,0,0,0,0,0,0,0,0,0,8,15,15,5,1,0,0,0,0,0,0,0,0,0,0,0,0,6,15,13,8,4,2,1,1,2,18,25,16,0,0,0,0,1,2,3,3,3,3,4,4,4,4,3,3,3,3,3,3,3,3,4,6,8,11,14,16,13,10,9,13,15,13,8,9,10,13,22,23,13,6,5,1,0,0,5,7,4,0,0
0,0,0,0,0,0,0,0,0,0,0,0,0,0,0,0,0,0,0,0,4,8,4,0,0,0,0,0,0,0,0,0,0,0,0,0,0,0,2,4,3,0,0,0,0,0,7,12,7,0,0,0,0,0,0,1,2,2,2,2,3,3,2,2,2,1,1,2,2,2,1,1,3,4,5,9,12,12,11,10,13,13,11,8,10,14,17,24,23,13,6,4,1,0,0,3,5,3,0,0
0,0,0,0,0,0,0,0,0,0,0,0,0,0,0,0,0,0,0,0,0,0,0,0,0,0,0,0,0,0,0,0,0,0,0,0,0,0,0,0,0,0,0,0,0,0,0,0,0,0,0,0,0,0,0,0,0,0,0,0,0,0,0,0,0,0,0,0,0,0,0,0,0,0,1,5,10,11,8,8,11,13,9,7,9,12,18,26,25,15,7,5,2,0,0,2,3,2,0,0
0,0,0,0,0,0,0,0,0,0,0,0,0,0,0,0,0,0,0,0,0,0,0,0,0,0,0,0,0,0,0,0,0,0,0,0,0,0,0,0,0,0,0,0,0,0,0,0,0,0,0,0,0,0,0,0,0,0,0,0,0,0,0,0,0,0,0,0,0,0,0,0,0,0,0,2,9,12,9,5,9,14,11,6,6,8,15,25,28,20,11,7,4,1,0,2,4,2,0,0
0,0,0,0,0,0,0,0,0,0,0,0,0,0,0,0,0,0,0,0,0,0,0,0,0,0,0,0,0,0,0,0,0,0,0,0,0,0,0,0,0,0,0,0,0,0,0,0,0,0,0,0,0,0,0,0,0,0,0,0,0,0,0,0,0,0,0,0,0,0,0,0,0,0,0,0,6,10,8,3,6,13,14,7,5,6,11,21,31,28,18,9,6,2,0,3,4,3,0,0
0,0,0,0,0,0,0,0,0,0,0,0,0,0,0,0,0,0,0,0,0,0,0,0,0,0,0,0,0,0,0,0,0,0,0,0,0,0,0,0,0,0,0,0,0,0,0,0,0,0,0,0,0,0,0,0,0,0,0,0,0,0,0,0,0,0,0,0,0,0,0,0,0,0,0,0,3,7,8,5,5,9,13,9,6,5,9,17,30,29,20,12,9,4,0,2,4,2,0,0
0,0,0,0,0,0,0,0,0,0,0,0,0,0,0,0,0,0,0,0,0,0,0,0,0,0,0,0,0,0,0,0,0,0,0,0,0,0,0,0,0,0,0,0,0,0,0,0,0,0,0,0,0,0,0,0,0,0,0,0,0,0,0,0,0,0,0,0,0,0,0,0,0,0,1,2,4,6,8,7,6,6,9,10,9,7,8,14,24,23,15,12,11,8,4,4,3,1,0,0
0,0,0,0,0,0,0,0,0,0,0,0,0,0,0,0,0,0,0,0,0,0,0,0,0,0,0,0,0,0,0,0,0,0,0,0,0,0,0,0,0,0,0,0,0,0,0,0,0,0,0,0,0,0,0,0,0,0,0,0,0,0,0,0,0,0,0,0,0,0,0,0,0,0,2,5,6,6,7,7,6,7,7,10,12,9,7,13,19,16,10,10,12,10,8,8,4,0,0,0
0,0,0,0,0,0,0,0,0,0,0,0,0,0,0,0,0,0,0,0,0,0,0,0,0,0,0,0,0,0,0,0,0,0,0,0,0,0,0,0,0,0,0,0,0,0,0,0,0,0,0,0,0,0,0,4,9,8,2,0,0,0,0,0,0,0,0,0,0,0,0,0,0,0,1,6,7,8,6,5,5,7,7,8,13,15,11,13,19,18,11,9,10,10,10,10,6,1,0,0
0,0,0,0,0,0,0,0,0,0,0,0,0,0,0,0,0,0,0,0,0,0,0,0,0,0,0,0,0,0,0,0,0,0,0,0,0,0,0,0,0,0,0,0,0,0,0,0,0,0,0,0,0,0,0,6,15,16,8,1,0,0,0,0,0,0,0,0,0,0,0,0,0,0,0,3,6,9,7,4,3,6,9,7,13,16,16,14,19,18,12,7,10,11,8,9,7,3,0,0
0,0,0,0,0,0,0,0,0,0,0,0,0,0,0,0,0,0,0,0,0,0,0,0,0,0,0,0,0,0,0,0,0,0,0,0,0,0,0,0,0,0,0,0,0,0,0,0,0,0,0,0,0,0,0,4,10,13,9,5,0,0,0,0,0,0,0,0,0,0,0,0,0,0,0,0,5,10,12,10,9,9,11,9,11,15,18,16,19,18,11,6,9,11,7,7,8,5,0,0
0,0,0,0,0,0,0,1,3,2,0,0,0,0,0,0,0,0,0,0,0,0,0,0,0,0,0,0,0,0,0,0,0,0,0,0,0,0,0,0,0,0,0,0,0,0,0,0,0,0,0,0,0,1,0,0,0,3,7,7,2,0,0,0,0,0,0,0,0,0,0,0,0,0,0,0,5,10,15,16,16,13,14,14,14,17,21,21,20,17,11,8,9,10,8,11,10,4,0,0
0,0,0,0,0,0,0,2,6,7,3,0,0,0,0,0,0,0,0,0,0,0,0,0,0,0,0,0,0,0,0,0,0,0,0,0,0,0,0,0,0,0,1,0,0,0,0,0,0,0,0,0,4,7,4,0,0,0,7,12,9,2,0,0,0,0,0,0,0,0,0,2,8,10,7,6,7,11,15,20,21,16,12,16,23,25,25,24,26,22,15,10,9,12,18,23,18,7,0,0
0,0,0,0,0,0,0,1,5,8,7,4,1,0,0,0,0,0,0,0,0,0,0,0,0,0,0,0,0,0,0,0,0,0,0,0,0,0,0,0,0,2,3,2,0,0,0,0,0,0,0,0,8,12,8,0,0,0,6,14,15,5,0,0,0,0,0,0,0,0,1,8,15,17,12,9,7,8,12,20,22,16,11,17,26,28,29,32,37,35,30,20,17,24,31,34,26,12,0,0
0,0,0,0,0,0,0,0,1,5,7,7,8,6,2,0,0,0,0,0,0,0,0,0,0,0,0,0,0,0,0,0,0,0,0,0,0,0,0,0,0,2,4,3,0,0,0,0,0,0,0,0,7,11,7,0,0,0,2,11,14,8,1,0,0,0,0,0,0,0,2,9,13,12,7,5,4,5,10,18,22,19,15,18,24,27,36,46,47,45,43,33,23,29,28,30,24,13,0,0
0,0,0,0,0,0,0,0,0,0,2,7,16,22,14,3,0,0,0,0,0,0,0,0,0,0,0,0,0,0,0,0,0,0,0,0,0,0,0,0,0,0,4,4,2,0,0,0,0,0,0,0,4,7,4,0,0,0,0,3,8,8,3,0,0,0,0,0,0,0,3,6,5,1,0,0,0,2,7,11,16,19,19,22,30,35,43,50,46,41,43,37,25,21,15,14,15,9,0,0
0,0,0,0,1,1,0,0,0,0,0,2,16,24,20,9,5,3,0,0,0,0,0,0,0,0,0,0,0,0,0,0,0,0,0,0,0,0,0,0,0,0,2,5,4,0,0,0,0,0,0,0,4,6,4,0,0,0,0,0,4,7,4,0,0,0,0,0,0,0,1,5,7,4,1,0,3,6,6,7,11,16,16,21,34,41,44,46,38,31,35,35,29,20,12,12,12,6,0,0
0,0,0,1,2,2,0,0,0,0,0,0,5,12,11,8,7,6,4,2,0,0,0,0,0,0,0,0,0,0,0,0,1,1,2,1,0,0,0,0,0,0,1,3,4,3,0,0,0,0,0,0,3,5,3,0,0,0,0,0,2,6,7,2,0,0,0,0,0,0,3,11,13,9,6,7,11,13,15,18,26,34,30,26,33,42,45,46,39,34,35,36,32,26,20,26,26,12,0,0
0,0,0,1,3,3,2,0,0,0,0,0,0,0,0,3,5,6,5,4,3,3,2,0,0,0,0,0,0,0,0,0,1,2,3,4,3,1,0,0,0,0,0,1,3,5,5,2,0,0,0,0,1,3,3,1,0,0,0,0,0,11,17,10,0,0,0,0,0,0,19,41,43,40,46,44,44,55,65,71,71,65,56,45,39,44,52,66,92,125,128,118,112,105,94,125,120,56,0,0
0,0,0,0,2,5,4,1,0,0,0,0,0,0,0,0,0,1,3,4,4,4,4,3,1,0,0,0,0,0,0,0,0,0,2,4,4,3,1,0,0,0,0,0,1,11,14,8,0,0,0,0,0,2,3,2,0,0,0,0,0,14,23,17,1,0,0,0,0,0,27,50,55,53,64,60,58,69,86,87,77,82,92,78,54,52,66,95,134,168,170,159,148,143,128,171,152,78,0,0
0,0,0,0,0,3,5,3,0,0,0,0,0,0,0,0,0,0,0,0,2,3,3,3,4,3,1,0,1,0,0,0,0,0,0,1,3,3,3,2,0,0,0,0,1,19,27,16,0,0,0,0,0,2,3,2,0,0,0,0,0,9,20,15,3,0,0,0,0,0,13,30,31,31,38,33,31,39,47,46,36,65,102,104,66,53,76,102,114,108,99,91,90,85,77,96,91,40,0,0
0,0,0,0,0,1,3,8,10,6,1,0,0,0,0,0,0,0,0,0,0,0,0,2,4,4,3,3,3,1,0,0,0,0,0,0,0,1,3,3,2,0,0,0,3,26,37,21,0,0,0,0,0,1,5,5,2,0,0,0,0,3,10,11,5,0,0,0,0,0,0,0,0,0,0,0,0,0,0,0,0,33,77,88,66,54,73,92,65,16,0,0,0,0,0,0,0,0,0,0
0,0,0,0,0,0,0,9,15,15,11,9,5,2,0,0,0,0,0,0,0,0,0,0,1,3,4,5,5,4,4,7,6,2,0,0,0,0,2,5,5,3,0,0,4,29,39,21,0,0,0,0,0,0,8,11,7,0,0,0,0,1,6,10,7,1,0,0,0,0,0,0,0,0,0,0,0,0,0,0,0,8,27,47,54,57,69,76,52,15,0,0,0,0,0,0,0,0,0,0
0,0,0,0,0,0,0,4,10,14,15,15,9,5,3,3,3,1,0,0,0,0,0,0,0,0,2,4,5,6,8,12,12,9,3,0,0,0,3,9,12,7,2,1,7,27,32,16,0,0,0,0,0,0,8,13,8,0,0,0,0,0,3,7,6,2,0,0,0,0,0,0,0,0,0,0,0,0,0,0,0,0,6,20,42,57,68,67,47,16,0,0,0,0,0,0,0,0,0,0
0,0,0,0,0,0,0,0,0,4,9,9,6,4,4,5,5,4,2,1,1,0,0,0,0,0,0,1,4,6,7,9,11,10,10,10,8,4,5,11,16,15,8,6,11,23,22,9,0,0,0,0,0,0,4,9,6,1,0,0,0,0,7,14,10,2,0,0,0,0,0,0,0,0,0,0,0,0,0,0,0,0,5,19,41,55,62,63,46,18,2,1,0,0,0,0,0,0,0,0
0,0,0,0,0,0,0,0,0,0,0,0,0,1,2,3,4,4,3,3,2,1,0,0,0,0,0,0,1,3,3,3,4,5,11,14,14,8,6,8,13,17,19,17,16,23,23,11,0,0,0,0,0,0,1,5,5,2,0,0,0,0,10,19,17,5,3,3,1,0,0,0,0,0,0,0,0,0,0,0,0,0,5,22,42,50,56,60,48,19,5,2,1,0,0,0,0,0,0,0
0,0,0,0,0,0,0,0,0,0,0,0,0,0,0,0,0,1,2,2,3,3,2,1,0,0,0,0,0,0,2,3,2,1,4,9,9,7,7,6,8,23,33,29,17,26,26,14,0,0,0,0,0,0,0,2,4,4,0,0,0,0,5,19,23,15,10,10,5,0,0,0,0,0,0,0,0,0,0,0,0,0,6,24,40,43,50,58,47,22,8,3,1,0,0,0,0,0,0,0
0,0,0,0,0,0,0,0,0,0,0,0,0,0,0,0,0,0,0,0,1,2,3,2,1,0,0,0,0,0,0,2,3,2,0,0,1,3,6,8,8,23,33,29,15,24,28,14,0,0,0,0,0,0,0,0,3,4,2,0,0,0,0,15,27,24,16,12,5,0,0,0,0,0,0,0,0,0,0,0,0,0,7,22,32,34,44,56,46,24,10,5,3,0,0,0,0,0,0,0
0,0,0,0,0,0,0,0,0,0,0,0,0,0,0,0,0,0,0,0,0,1,2,3,3,1,0,0,0,0,0,0,2,3,2,0,0,2,4,6,8,14,19,16,11,26,30,15,0,0,0,0,0,0,0,0,2,4,2,2,5,5,2,14,27,29,22,16,6,0,0,0,0,0,0,0,0,0,0,0,0,2,8,21,27,27,35,54,48,26,9,7,4,3,1,0,0,0,0,0
0,0,0,0,0,0,0,0,0,0,0,0,0,0,0,0,0,0,0,0,0,0,0,1,2,2,2,0,0,2,3,1,1,2,2,1,0,0,1,3,5,5,4,8,14,34,40,21,0,0,0,0,0,0,0,0,1,3,2,5,10,10,5,10,21,27,32,28,12,0,0,0,0,0,0,0,0,0,0,0,0,2,7,21,25,20,25,50,52,32,12,6,4,4,3,0,0,0,0,0
0,0,0,0,0,0,0,0,0,0,0,0,0,0,0,0,0,0,0,0,0,0,0,0,1,2,2,2,3,4,6,6,4,5,7,8,5,2,2,7,9,7,7,11,15,39,47,26,0,0,0,0,1,3,4,3,3,4,5,8,14,17,10,7,13,24,39,35,16,0,0,0,0,0,0,0,0,0,0,0,0,2,7,20,25,19,20,44,53,36,16,7,4,5,5,1,0,0,0,0
0,0,0,0,0,0,0,0,0,0,0,0,0,0,0,0,0,0,0,0,0,0,0,0,0,0,2,3,4,5,6,6,7,7,9,10,9,6,7,11,13,13,16,15,11,36,49,29,0,0,0,1,4,6,6,5,4,5,7,9,17,20,14,7,10,22,38,35,13,0,0,0,0,0,0,0,0,0,0,0,0,2,7,17,24,20,21,38,51,37,19,8,4,3,4,3,0,0,0,0
0,0,0,0,0,0,0,0,0,0,0,0,0,0,0,0,0,0,0,1,2,2,1,0,0,0,0,1,3,3,3,4,4,4,5,6,8,7,9,10,11,12,18,21,16,35,48,29,0,0,0,2,4,5,4,3,2,2,5,7,15,18,13,6,9,21,49,53,25,0,0,0,0,0,0,0,0,0,0,0,0,1,7,18,26,23,21,34,50,40,21,10,5,1,4,4,1,0,0,0
0,0,0,0,0,0,0,0,0,0,0,0,0,0,0,0,0,0,1,2,4,4,4,2,0,0,0,0,0,2,2,2,1,0,0,0,2,5,6,5,5,6,12,23,29,56,63,37,7,8,7,6,5,3,1,1,2,2,4,7,11,13,10,4,6,17,68,86,48,0,0,0,0,0,1,3,3,2,0,0,0,1,8,21,28,22,20,34,49,43,27,13,5,0,3,5,4,0,0,0
0,0,0,0,0,0,0,0,0,0,0,0,0,0,0,0,0,0,0,1,2,3,4,4,3,1,0,0,0,0,1,3,3,1,0,0,0,2,5,6,5,1,7,19,34,61,67,42,15,16,15,15,14,13,15,15,14,13,14,14,14,15,13,8,5,17,71,87,49,0,0,0,1,3,6,6,5,4,3,3,3,3,12,23,32,26,24,32,47,45,33,16,4,0,2,5,5,1,0,0
0,0,0,0,0,0,0,0,0,0,0,0,0,0,0,0,0,0,0,0,0,0,2,3,6,9,8,7,8,6,4,4,4,4,2,0,0,0,4,7,6,2,8,17,26,42,50,35,20,19,21,23,21,21,23,25,24,23,24,22,21,22,21,17,21,34,60,62,34,8,8,8,9,9,10,9,8,7,6,5,4,7,21,34,42,35,30,30,43,47,38,18,4,0,0,4,5,3,0,0
0,0,0,0,0,0,0,0,0,0,0,0,0,0,0,0,0,0,0,0,0,0,0,0,7,12,13,14,17,17,10,6,6,8,8,6,4,4,7,15,16,8,9,16,17,18,23,25,22,22,24,23,21,18,19,19,18,19,19,24,34,36,28,23,31,46,51,41,28,21,20,18,16,13,11,10,10,10,11,13,11,15,31,46,53,44,34,29,40,47,42,22,6,0,0,11,19,11,0,0
0,0,0,0,0,0,0,0,0,0,0,0,0,0,0,0,0,0,0,0,0,0,0,0,3,7,9,11,16,16,12,8,9,10,10,9,10,9,12,20,24,19,13,15,15,17,22,30,31,29,25,21,15,12,10,9,9,10,11,22,37,44,34,27,33,45,46,39,34,33,31,31,29,26,23,18,15,15,18,20,22,26,35,43,47,41,34,33,38,46,45,28,10,1,0,22,34,22,0,0
0,0,0,0,0,0,0,0,0,0,0,0,0,0,0,0,0,0,0,0,0,0,0,0,0,0,0,2,4,6,6,6,8,8,8,9,11,12,15,18,25,24,18,11,13,20,30,36,32,24,16,14,13,12,11,10,10,10,10,15,28,38,37,37,40,49,52,45,33,31,31,34,37,40,38,37,36,35,28,24,26,32,31,32,33,32,33,36,42,49,50,35,15,3,0,29,48,29,0,0
0,0,0,0,0,0,0,0,0,0,0,0,0,0,0,0,0,0,0,0,0,0,0,0,0,0,0,0,0,0,1,2,4,4,4,4,6,8,12,14,22,24,17,8,13,29,48,58,45,22,9,10,9,12,15,12,9,9,8,9,15,25,32,42,44,61,66,54,33,30,33,40,46,50,53,61,63,61,48,36,29,34,34,35,29,27,31,42,51,52,50,36,20,6,3,32,44,27,0,0
0,0,0,0,0,0,0,0,1,1,0,0,0,0,0,0,0,0,0,0,0,0,0,0,0,0,0,0,0,0,0,0,0,1,2,2,2,3,9,15,22,19,10,3,18,46,63,62,42,22,7,7,7,14,19,17,8,5,4,7,12,19,25,29,33,53,66,56,35,32,33,38,39,39,46,55,58,57,54,51,41,38,36,41,35,29,32,48,56,52,44,35,24,14,13,32,39,20,0,0
0,0,0,0,0,0,0,1,3,3,3,2,1,0,0,0,0,0,0,0,0,0,0,0,0,0,1,4,6,5,3,0,0,0,0,0,0,0,6,14,19,14,6,3,32,63,61,37,23,12,4,4,6,13,19,16,10,7,5,6,9,13,17,15,16,39,66,68,55,48,44,39,34,26,28,29,26,29,40,47,53,57,53,49,45,34,32,49,65,55,43,40,37,27,22,35,37,19,0,0
0,0,0,0,0,0,0,0,2,3,4,4,3,5,8,7,4,3,3,4,4,1,0,0,0,1,4,7,9,8,6,5,4,5,5,5,5,6,12,18,19,12,7,6,45,76,55,9,0,0,0,2,11,18,14,9,8,9,12,12,8,7,11,12,20,46,70,70,55,42,40,39,31,20,17,14,16,24,32,34,46,64,74,76,72,50,36,49,69,64,55,61,63,46,32,43,41,22,0,0
0,0,0,0,0,0,0,0,0,1,2,3,3,8,12,12,7,4,5,9,10,7,4,3,2,2,4,6,6,6,7,9,9,10,9,8,8,9,14,18,19,15,12,13,50,74,54,9,0,0,0,2,16,22,14,2,2,5,14,23,22,12,11,16,46,78,88,64,37,20,44,68,59,28,16,16,21,37,39,30,29,53,76,93,90,66,47,52,64,60,61,81,83,63,41,58,61,31,0,0
0,0,0,0,0,0,0,0,0,0,0,0,1,4,8,7,4,3,3,7,10,9,6,5,4,4,5,3,2,2,5,7,8,7,6,5,5,6,8,12,12,10,11,18,42,58,39,9,0,0,0,1,12,18,10,2,3,3,12,26,31,28,22,27,59,84,82,43,15,0,47,87,75,27,11,8,17,33,39,29,19,27,56,78,79,60,54,53,51,47,57,73,71,57,42,72,79,47,0,0
0,0,0,0,0,0,0,0,0,0,0,0,0,0,0,0,0,0,0,1,4,4,4,3,3,4,4,4,3,3,2,2,2,1,0,0,0,1,5,9,8,6,7,14,24,30,21,6,0,0,0,0,4,9,10,9,9,9,8,13,26,34,36,31,46,65,64,37,11,0,41,75,59,13,3,1,7,17,26,23,21,25,44,59,60,50,50,59,61,63,59,54,42,38,33,76,93,55,0,0
0,0,0,0,0,0,0,0,0,0,0,0,0,0,0,0,0,0,0,0,0,0,0,0,0,2,3,2,2,1,0,0,0,0,0,0,1,3,8,10,8,5,5,5,9,26,32,16,0,0,0,0,0,5,9,12,12,13,12,9,14,30,38,30,27,35,48,38,14,0,23,40,28,4,1,1,7,12,17,22,26,31,43,67,72,55,48,66,82,82,63,45,31,30,27,69,82,47,0,0
0,0,0,0,0,0,0,0,0,0,0,0,0,0,0,0,0,0,0,0,0,0,0,0,0,0,0,0,0,0,0,0,0,0,0,0,1,3,7,8,6,3,2,1,1,28,39,25,0,0,0,0,0,2,5,6,6,9,11,13,20,32,33,25,21,25,41,38,19,0,16,30,26,10,8,11,15,19,19,23,33,39,44,63,70,58,49,67,85,86,65,46,39,29,22,49,61,32,0,0
0,0,0,0,0,0,0,0,0,0,0,0,0,0,1,2,2,3,2,2,2,4,7,7,6,9,8,5,4,3,3,3,3,3,2,2,3,3,6,8,10,11,8,3,2,24,40,23,0,0,0,0,0,0,2,8,11,10,11,27,52,72,72,53,28,16,33,46,25,0,18,41,47,43,49,58,68,69,76,83,76,53,40,44,51,47,54,71,96,109,112,128,153,136,89,104,117,61,0,0
0,0,0,0,0,0,0,0,0,0,0,0,0,1,2,3,4,4,4,3,3,7,11,11,11,14,13,9,6,5,4,4,4,4,4,3,3,3,6,8,14,16,13,6,4,18,23,15,0,0,0,0,0,0,4,13,17,14,9,31,57,87,82,62,29,13,30,39,26,0,19,35,51,50,66,77,90,88,101,116,122,88,52,37,44,54,86,121,145,127,129,164,205,192,126,143,136,85,0,0
0,0,0,0,0,0,0,0,0,0,0,0,0,0,1,2,2,3,2,2,2,4,7,7,6,9,8,5,4,3,3,3,3,3,2,2,2,2,3,4,8,11,8,3,2,9,15,8,0,0,0,0,0,0,2,8,11,8,6,16,31,45,47,34,13,5,16,25,13,0,9,18,22,26,35,43,51,50,57,81,102,89,64,59,74,77,108,148,138,88,66,94,123,115,77,81,89,46,0,0
0,0,0,0,0,0,0,0,0,0,0,0,0,0,0,0,0,0,0,0,0,0,0,0,0,0,0,0,0,0,0,0,0,0,0,0,0,0,0,0,0,0,0,0,0,0,0,0,0,0,0,0,0,0,0,0,0,0,0,0,0,0,0,0,0,0,0,0,0,0,0,0,0,0,0,0,0,0,0,10,36,52,55,65,77,73,87,103,76,19,0,0,0,0,0,0,0,0,0,0
0,0,0,0,0,0,0,0,0,0,0,0,0,0,0,0,0,0,0,0,0,0,0,0,0,0,0,0,0,0,0,0,0,0,0,0,0,0,0,0,0,0,0,0,0,0,0,0,0,0,0,0,0,0,0,0,0,0,0,0,0,0,0,0,0,0,0,0,0,0,0,0,0,0,0,0,0,0,0,0,3,13,26,40,44,36,36,33,16,0,0,0,0,0,0,0,0,0,0,0
