0,0,0,0,0,0,0,0,0,0,0,0,0,0,0,0,0,0,0,0,0,0,0,0,0,0,0,0,0,0,0,0,0,0,0,0,0,0,0,0,0,0,0,0,0,0,0,0,0,0,0,0,0,0,0,0,0,0,0,0,0,0,0,0,0,0,0,0,0,0,0,0,0,0,0,0,0,0,0,0,0,0,0,0,0,0,0,0,0,0,0,0,0,0,0,0,0,0,0,0
0,0,0,0,0,0,0,0,0,0,0,0,0,0,0,0,0,0,0,0,0,0,0,0,0,0,0,0,0,0,0,0,0,0,0,0,0,0,0,0,0,0,0,0,0,0,0,0,0,0,0,0,0,0,0,0,0,0,0,0,0,0,0,0,0,2,8,9,3,0,0,0,0,0,0,0,0,0,0,0,0,0,0,0,0,0,0,0,0,0,0,0,0,0,0,0,0,0,0,0
0,0,0,0,0,0,0,0,0,0,0,0,0,0,0,0,0,0,0,0,0,0,0,0,0,0,0,0,0,0,0,0,0,0,0,0,0,0,0,0,0,0,0,0,0,0,0,0,0,0,0,0,0,0,0,0,0,0,0,0,0,0,0,0,0,5,15,17,7,0,0,0,0,0,0,0,0,0,0,0,0,0,0,0,0,0,0,0,0,0,0,0,0,0,0,0,0,0,0,0
0,0,0,0,0,0,0,0,0,0,0,0,0,0,0,0,0,0,0,0,0,0,0,0,0,0,0,0,0,0,0,0,0,0,0,0,0,0,0,0,0,0,0,0,0,0,0,0,0,0,0,0,0,0,0,0,0,0,0,0,0,0,0,1,1,4,14,17,8,0,0,0,0,0,0,0,0,0,0,0,0,0,0,0,0,0,0,0,0,0,0,0,0,0,0,0,0,0,0,0
0,0,0,0,0,0,0,0,0,0,0,1,0,0,0,0,0,0,0,0,0,0,0,0,0,0,0,0,0,0,0,0,0,0,0,0,0,0,0,0,0,0,0,0,0,0,0,0,0,0,0,0,0,0,0,0,0,0,0,1,1,1,1,1,2,2,10,14,8,0,0,0,0,0,1,1,1,0,0,0,0,0,0,0,0,0,0,0,0,0,0,0,0,0,0,0,0,0,0,0
0,0,0,0,0,0,0,0,0,0,1,2,1,0,0,0,0,0,0,0,0,0,0,0,0,0,0,0,0,0,0,0,0,0,0,0,0,0,0,0,0,0,0,0,0,0,0,0,0,0,0,0,0,0,0,0,0,0,0,0,0,0,0,1,2,3,12,15,9,0,0,0,0,0,1,2,1,1,0,0,0,0,0,0,0,0,0,0,0,0,0,0,0,0,0,0,0,0,0,0
0,0,0,0,0,0,0,0,0,0,0,1,1,1,0,0,1,0,0,0,0,0,0,0,0,0,0,0,0,0,0,0,0,0,0,0,0,0,0,0,0,0,0,0,0,0,0,0,0,0,0,0,0,0,0,0,0,1,0,0,0,0,0,1,2,5,13,16,8,0,0,0,0,1,1,0,1,1,0,0,0,0,0,0,0,0,0,0,0,0,0,0,0,0,0,0,0,0,0,0
0,0,0,0,0,0,0,1,1,0,0,0,0,0,0,0,0,0,0,0,0,1,0,0,0,0,0,1,0,0,0,0,0,0,0,0,0,0,0,0,0,0,0,0,0,0,0,0,0,0,0,0,1,0,0,0,0,0,0,0,0,0,1,2,3,5,13,15,8,0,0,0,0,1,0,0,0,2,2,0,0,0,0,0,0,0,0,0,0,0,0,0,0,0,0,0,0,0,0,0
0,0,0,0,0,0,0,1,1,0,0,0,0,0,0,0,0,0,0,0,0,0,0,0,0,0,0,0,0,0,0,0,0,0,0,0,0,0,0,0,0,0,0,0,1,1,1,1,1,1,0,0,0,0,0,0,0,0,0,0,1,1,2,2,2,2,9,12,6,0,0,0,1,1,0,0,0,2,3,2,0,0,0,0,0,0,0,0,0,0,0,0,0,0,0,0,0,0,0,0
0,0,0,0,0,0,0,1,1,0,0,0,0,0,0,0,0,0,0,0,0,0,0,0,0,0,0,0,0,0,0,1,1,0,0,0,0,0,0,1,0,0,0,0,0,1,2,2,1,1,1,1,0,0,1,0,0,0,1,1,1,2,2,2,0,1,5,6,3,0,0,0,1,1,0,0,0,1,2,2,1,0,0,0,0,0,0,0,0,0,0,0,0,0,0,0,0,0,0,0
0,0,0,0,0,0,0,0,1,0,0,0,0,0,0,0,0,0,0,0,0,0,0,0,0,0,0,0,0,0,0,1,1,0,0,1,0,0,0,1,1,0,0,0,0,1,1,1,0,1,1,1,0,0,0,0,0,0,1,1,2,3,2,2,1,2,5,8,8,4,1,0,0,1,1,0,0,0,1,2,2,1,0,0,0,0,0,0,0,0,0,0,0,0,0,0,0,0,0,0
0,0,0,0,0,0,0,0,0,0,0,0,0,0,0,0,0,0,0,0,0,0,0,0,0,0,0,0,0,0,0,1,1,0,0,0,0,0,0,2,3,2,0,0,0,1,0,0,0,0,1,1,0,0,0,0,0,0,0,2,3,4,4,3,2,3,6,13,14,9,2,1,1,3,3,2,0,0,1,2,3,3,2,1,0,0,0,0,0,0,0,0,0,0,0,0,0,0,0,0
0,0,0,0,0,0,0,0,0,0,0,0,0,0,0,0,0,0,0,0,0,0,0,0,0,0,0,0,0,0,0,1,0,0,0,0,0,0,1,2,3,2,1,0,0,0,0,0,0,0,0,0,0,0,1,0,0,0,1,2,3,5,4,3,2,2,6,12,14,8,3,2,3,5,6,5,1,1,2,2,3,4,3,2,0,0,0,0,0,0,0,0,0,0,0,0,0,0,0,0
0,0,0,0,0,0,0,0,0,0,0,1,0,0,0,0,0,0,0,0,0,0,0,0,0,0,0,0,0,0,0,0,0,0,0,0,0,1,1,0,1,1,1,1,0,0,0,0,0,0,1,1,1,2,2,1,0,1,3,3,3,4,3,2,1,1,6,11,9,4,4,4,3,5,7,7,4,2,1,2,2,4,4,3,1,0,0,0,0,0,0,0,0,0,0,0,0,0,0,0
0,0,0,0,0,0,0,0,0,0,0,0,0,0,0,0,0,0,0,0,0,0,0,0,0,0,0,0,0,0,0,0,0,0,0,0,0,1,0,0,0,0,1,1,1,1,1,1,0,1,1,1,2,3,3,2,1,2,4,6,5,4,2,2,2,2,7,11,9,4,4,4,3,3,5,9,9,6,2,0,2,3,3,3,3,1,0,0,0,0,0,0,0,0,0,0,0,0,0,0
0,0,0,0,0,0,0,0,0,0,0,0,0,0,0,0,0,0,0,0,0,0,0,0,0,0,1,0,0,1,1,0,0,1,0,0,0,1,0,0,0,1,1,1,1,1,0,1,1,1,1,1,1,3,3,2,0,1,3,5,4,3,3,4,5,4,6,9,10,6,4,4,6,8,9,10,11,7,4,2,3,2,2,3,4,3,1,0,0,0,0,0,0,0,0,0,0,0,0,0
0,0,0,0,0,0,0,0,0,0,0,0,0,0,0,1,0,0,0,0,0,0,0,0,0,0,0,0,0,2,1,0,0,1,1,0,0,1,0,0,0,0,0,1,1,0,0,0,0,0,0,0,0,0,1,1,0,0,1,3,3,4,5,5,5,5,7,10,10,7,6,6,11,13,13,8,8,6,5,5,6,5,3,2,3,3,1,0,0,0,0,0,0,0,0,0,0,0,0,0
0,0,0,0,0,0,0,0,0,0,0,0,0,0,0,0,0,0,0,0,0,0,0,0,0,0,0,0,2,2,1,0,0,0,1,0,0,0,0,0,0,0,0,0,0,0,0,0,0,0,1,1,0,0,0,1,1,1,1,2,5,6,7,6,4,5,9,12,9,5,5,7,10,11,9,4,3,2,4,5,7,7,5,2,2,3,2,1,0,0,0,0,0,0,0,0,0,0,0,0
0,0,0,0,0,0,0,0,0,0,0,0,0,0,0,0,0,0,0,0,1,1,0,0,0,0,0,1,2,2,0,0,0,0,0,0,0,0,0,0,0,0,0,0,0,0,0,0,0,0,0,1,1,0,0,1,1,1,1,4,7,9,7,6,6,6,10,10,6,1,2,4,4,3,2,1,1,1,1,1,5,8,7,4,2,3,2,1,0,0,0,0,0,0,0,0,0,0,0,0
0,0,0,0,0,0,0,0,0,0,0,0,0,0,0,0,0,0,0,0,1,1,0,0,0,0,0,0,1,0,0,0,0,0,0,0,0,0,0,1,1,0,0,0,0,0,0,1,1,0,0,0,0,0,0,0,0,0,0,4,9,9,7,7,8,7,8,7,3,0,0,0,1,1,0,0,0,0,0,0,2,5,7,6,4,3,2,1,0,0,0,0,0,0,0,0,0,0,0,0
0,0,0,0,0,0,0,0,0,0,0,0,0,0,0,0,1,0,0,0,0,0,0,0,0,0,0,0,0,0,0,0,0,0,0,0,0,0,1,2,2,1,0,0,1,1,1,1,0,0,0,0,0,0,0,0,0,0,0,3,7,8,6,6,7,7,8,6,3,0,0,0,1,1,0,0,0,0,0,0,0,2,7,8,6,3,2,1,1,1,0,0,0,0,0,0,0,0,0,0
0,0,0,0,0,0,0,0,0,0,0,0,0,0,0,0,0,0,0,0,0,0,0,0,0,1,0,0,0,0,0,0,0,0,0,0,0,0,0,1,2,1,0,0,0,0,0,0,0,0,0,0,0,0,0,0,0,0,0,1,4,6,5,3,5,7,11,9,4,0,0,0,0,1,0,0,0,0,0,0,0,0,4,7,7,4,3,2,2,2,1,0,0,0,0,0,0,0,0,0
0,0,0,0,0,0,0,0,0,0,0,0,2,1,0,0,0,0,0,0,0,0,0,0,0,0,0,0,1,1,0,0,0,0,0,0,0,0,0,0,1,1,0,0,0,0,0,0,0,0,0,0,0,0,0,0,1,0,0,0,2,3,4,2,2,5,10,11,5,0,0,0,0,1,0,0,0,0,0,0,0,0,1,5,6,5,4,3,2,2,1,0,0,0,0,0,0,0,0,0
0,0,0,0,0,0,0,0,0,0,0,1,2,2,0,0,0,0,0,0,0,0,0,0,0,0,0,1,1,0,0,0,0,1,0,0,0,0,0,0,1,0,0,0,0,0,0,0,0,0,0,0,0,0,0,0,1,0,0,0,1,3,4,3,1,2,9,12,6,0,0,0,0,0,0,0,0,0,0,0,0,0,1,3,5,6,5,3,2,1,0,0,0,0,0,0,0,0,0,0
0,0,0,0,0,0,0,0,0,0,0,0,1,0,0,0,0,0,0,0,0,0,0,1,1,0,0,0,0,0,0,0,0,0,0,0,0,1,0,0,0,0,0,0,0,0,0,0,0,1,0,0,0,0,0,1,1,1,0,0,0,2,4,3,1,1,10,14,8,0,0,0,0,0,0,0,0,0,0,0,0,0,1,2,4,6,5,3,2,1,0,0,0,0,0,0,0,0,0,0
0,0,0,0,0,0,0,0,0,0,0,0,0,0,0,0,0,0,0,0,1,2,1,1,0,0,0,0,0,0,0,0,0,0,0,0,1,1,1,0,0,0,0,0,0,0,0,0,0,1,1,1,1,1,1,1,0,1,1,0,0,1,2,1,0,1,13,20,11,0,0,0,0,0,0,0,0,0,0,0,0,0,0,0,3,6,6,4,4,2,0,0,0,0,0,0,0,0,0,0
0,0,0,0,0,0,0,0,0,0,0,0,0,0,0,0,0,0,0,1,2,2,1,0,0,0,0,0,0,0,0,0,0,0,0,0,1,1,1,1,1,1,0,0,0,0,0,0,0,0,1,2,2,2,1,1,0,0,0,0,0,1,1,1,0,0,18,28,17,0,0,0,0,1,0,0,0,0,0,0,0,0,0,1,3,6,7,6,4,2,0,0,0,0,0,0,0,0,0,0
0,0,0,0,0,0,0,0,0,0,0,0,0,0,0,0,0,0,0,0,1,1,0,0,0,0,0,0,0,0,0,0,0,0,0,0,1,1,0,0,0,0,0,0,1,1,1,0,0,0,0,1,1,1,0,0,0,0,0,0,0,1,2,1,0,0,16,24,15,0,0,0,0,0,0,0,0,0,1,0,0,0,0,1,2,6,6,5,3,2,0,0,0,0,0,0,0,0,0,0
0,0,0,0,0,0,0,0,0,0,0,0,0,0,0,0,0,0,0,0,0,0,0,0,0,0,0,0,0,0,0,0,0,0,0,0,0,0,0,0,0,0,0,0,0,0,0,0,0,0,0,0,0,0,0,0,0,0,0,0,0,0,1,1,0,0,7,11,6,0,0,0,0,0,0,0,0,0,0,0,0,0,0,1,1,4,5,3,1,1,1,0,0,0,0,0,0,0,0,0
0,0,0,0,0,0,0,0,0,0,0,0,0,0,0,0,0,0,0,0,0,0,0,0,0,0,0,0,0,0,0,0,0,0,0,0,0,0,0,0,0,0,0,0,0,0,0,0,0,0,0,0,0,0,0,0,0,0,0,0,0,0,0,0,0,0,0,0,0,0,0,0,0,0,0,1,1,0,0,0,0,0,0,0,1,4,5,4,3,2,0,0,0,0,0,0,0,0,0,0
0,0,0,0,0,0,0,0,0,0,0,0,0,0,0,0,0,0,0,0,0,0,0,0,0,0,0,0,0,0,0,0,0,0,0,0,0,0,0,0,0,0,0,0,0,0,0,0,0,0,0,0,0,0,0,0,0,0,0,0,0,0,0,0,0,0,0,0,0,0,0,0,0,0,0,0,1,1,0,0,0,0,0,0,3,5,7,7,5,2,0,0,0,0,0,0,0,0,0,0
0,0,0,0,0,0,0,0,0,0,0,0,0,0,0,0,0,0,0,0,0,0,0,0,0,0,0,0,0,0,0,0,0,0,0,0,0,0,0,0,0,0,0,0,0,0,0,0,0,0,0,0,0,0,0,0,0,0,0,0,0,0,0,0,0,0,0,0,0,0,0,0,0,0,0,0,0,0,0,0,0,0,1,1,2,3,5,7,6,3,1,1,0,0,0,0,0,0,0,0
0,0,0,0,0,0,0,0,0,0,0,0,0,0,0,0,0,0,0,0,0,0,0,0,1,1,0,0,0,0,0,0,0,0,0,0,0,0,0,0,0,0,0,0,0,0,0,0,0,0,0,0,0,0,0,0,0,0,0,0,0,0,0,0,0,0,0,0,0,0,0,0,0,0,0,1,1,0,0,1,0,0,0,0,0,1,4,7,6,3,1,1,1,0,0,0,0,0,0,0
0,0,0,0,0,0,0,0,0,0,0,1,1,0,0,0,0,0,0,0,0,1,1,1,1,1,1,1,1,1,1,1,1,0,0,0,0,0,0,0,0,0,0,0,0,0,0,0,0,0,0,0,0,0,0,0,0,0,0,0,0,0,0,0,0,0,0,0,0,0,0,0,0,0,1,2,2,0,0,0,0,0,0,1,1,1,3,5,5,2,1,2,3,2,0,0,0,0,0,0
0,0,0,0,0,0,0,0,0,0,1,2,2,1,1,1,0,0,0,0,0,1,1,1,1,1,0,0,0,0,0,1,1,1,0,0,1,1,0,0,1,1,0,0,0,0,0,0,0,0,0,0,0,0,0,0,0,0,0,0,0,0,0,0,0,0,0,0,0,0,0,0,0,0,1,2,1,0,0,0,0,0,0,1,2,1,2,4,4,2,1,3,4,2,0,0,0,0,0,0
0,0,0,0,0,0,1,1,0,0,0,1,1,0,0,0,0,1,1,1,1,1,1,0,0,0,0,0,0,0,0,0,1,1,0,0,0,1,1,1,1,1,0,0,0,0,0,1,0,0,0,0,0,0,0,0,0,0,0,0,0,0,0,0,0,0,0,0,0,0,0,0,0,0,0,1,0,0,0,0,0,0,1,1,1,1,2,3,4,3,2,2,2,1,0,0,0,0,0,0
0,0,0,0,1,1,1,0,0,0,0,0,0,0,0,0,0,1,1,1,1,1,1,1,0,0,1,1,0,0,0,0,0,0,0,0,0,0,0,0,1,1,0,0,1,1,2,3,2,0,0,0,0,0,0,0,0,0,0,0,0,0,0,1,0,0,1,0,0,1,1,1,1,1,1,1,1,0,0,0,0,0,1,0,0,1,2,4,4,3,2,2,2,1,0,0,0,0,0,0
0,0,0,0,1,2,1,0,0,0,0,0,0,0,0,0,0,1,1,1,1,1,1,1,0,0,1,1,0,0,0,0,0,0,0,0,0,0,0,0,0,0,0,0,0,1,2,3,2,1,1,0,0,0,0,0,0,0,0,0,0,0,0,0,0,0,1,0,0,1,1,1,1,1,1,1,1,1,1,1,1,1,1,0,0,1,2,3,3,2,2,3,2,2,0,0,0,0,0,0
0,0,0,0,0,1,1,0,0,0,0,0,0,0,0,0,0,1,1,1,1,0,0,0,0,0,0,0,0,0,0,1,0,0,0,0,0,0,0,0,0,0,0,0,0,0,1,1,1,1,0,0,0,1,1,1,1,1,0,0,0,1,0,0,0,0,1,1,0,1,1,0,0,0,0,0,1,2,1,0,1,1,1,0,1,1,2,3,3,2,3,3,2,1,0,0,0,0,0,0
0,0,0,0,0,0,0,0,0,0,0,0,0,0,0,0,0,2,2,1,0,0,0,0,0,0,0,0,0,0,1,1,0,0,0,1,1,2,0,0,0,1,0,0,0,0,0,0,1,1,1,0,1,3,3,3,2,2,1,1,0,0,0,0,0,0,1,1,0,0,0,0,0,0,0,0,1,1,1,0,1,2,2,1,1,1,1,3,3,3,4,3,2,1,0,0,0,0,0,0
0,0,0,0,0,0,0,0,1,1,0,0,0,0,0,0,1,3,3,1,0,0,0,0,0,0,0,1,2,2,1,0,0,1,1,1,2,2,1,0,1,2,2,0,1,1,1,0,2,2,1,1,1,2,3,3,2,2,2,2,1,0,2,4,3,1,0,0,0,0,0,0,0,0,0,1,1,0,0,0,1,1,1,1,3,3,3,3,3,3,3,3,3,2,0,0,1,0,0,0
0,0,0,0,0,0,0,0,0,1,1,0,0,0,0,0,1,2,2,0,0,0,0,0,0,1,0,1,3,2,1,1,0,1,2,1,0,1,0,0,0,2,1,0,1,1,1,0,1,2,1,1,1,1,1,2,2,1,1,3,3,1,3,5,5,2,2,1,1,1,1,1,1,0,0,1,1,0,0,0,1,2,1,1,4,4,4,3,2,2,2,2,2,1,0,3,4,2,0,0
0,0,0,0,0,0,0,0,0,0,0,0,0,0,0,0,1,2,1,0,0,0,1,0,0,0,0,0,2,2,2,2,1,1,1,1,0,0,0,1,1,2,2,1,0,0,0,0,1,1,0,0,1,0,0,1,1,0,1,3,4,2,2,4,5,3,2,2,2,2,3,3,2,1,0,1,1,1,1,1,3,3,2,1,2,4,4,3,2,2,2,1,1,1,2,5,5,2,0,0
0,0,0,0,0,0,0,0,0,0,0,0,0,1,0,0,2,2,2,1,1,0,0,0,0,0,0,1,1,1,2,2,0,0,1,1,0,0,1,2,2,3,2,1,0,0,0,1,1,0,0,0,1,1,1,1,1,0,1,3,3,1,0,2,4,4,1,1,1,2,3,3,3,2,2,3,4,3,1,1,3,3,2,0,1,2,3,4,3,3,2,1,2,5,6,6,4,1,0,0
0,0,0,0,0,0,0,0,0,0,0,0,0,0,0,0,2,2,1,1,2,1,0,0,1,1,1,1,1,1,0,0,0,0,0,1,0,0,1,2,2,2,1,1,0,0,2,2,1,1,1,1,1,1,1,1,1,1,2,3,2,0,1,4,5,4,1,0,0,1,1,1,2,2,2,3,4,3,3,3,3,2,1,1,1,2,3,4,3,3,3,3,4,7,7,5,3,1,0,0
0,0,0,0,0,0,0,0,0,0,0,0,0,0,0,0,1,1,1,2,2,1,0,0,1,2,1,1,1,0,0,0,0,0,1,1,0,2,2,2,1,1,1,1,0,1,2,2,1,2,2,2,1,1,1,0,0,2,3,3,1,1,4,4,3,2,2,1,2,3,2,1,0,1,2,2,2,2,3,5,5,2,2,2,2,4,5,4,2,3,3,4,6,8,7,5,3,1,0,0
0,0,0,0,0,0,0,0,0,0,0,0,0,0,0,0,0,0,2,3,2,1,1,1,1,1,1,1,1,0,0,0,0,0,1,0,0,2,3,2,1,2,2,2,1,2,2,1,0,2,3,2,1,1,2,1,1,2,3,1,0,2,4,4,2,2,3,1,2,3,4,2,1,2,3,2,1,1,3,6,6,3,2,2,4,6,6,4,2,3,4,6,6,8,6,5,3,2,0,0
0,0,0,0,0,0,0,0,0,0,0,0,0,0,0,0,0,0,1,3,3,2,4,3,1,0,0,0,0,0,0,0,0,0,0,0,0,1,1,1,1,1,1,1,1,1,1,0,0,1,2,2,1,1,1,2,2,2,3,3,1,2,3,1,1,2,2,1,1,2,3,2,1,2,3,2,2,3,4,5,5,4,2,3,5,9,9,5,3,5,6,8,7,7,6,6,4,1,0,0
0,0,0,0,0,0,0,0,0,0,0,0,0,0,0,0,0,0,1,2,4,4,6,5,2,0,0,0,0,0,0,0,0,0,0,0,0,0,0,0,0,0,0,0,0,0,0,0,0,0,0,0,0,0,0,1,1,0,3,4,3,2,2,1,0,1,1,0,0,0,0,0,0,1,2,2,2,3,5,5,4,3,3,4,6,10,11,8,5,7,8,8,6,5,5,6,5,2,0,0
0,0,0,0,0,0,0,0,0,0,0,0,0,0,0,0,0,1,1,2,4,4,5,5,2,0,0,0,0,0,0,0,0,0,0,0,0,0,0,0,0,0,0,0,0,0,0,0,0,0,0,0,0,0,0,0,0,1,3,3,3,2,2,1,0,0,0,0,0,0,0,0,0,1,3,3,2,4,7,8,5,3,3,5,6,10,12,12,9,9,8,6,6,5,5,10,11,5,0,0
0,0,0,0,0,0,0,0,0,0,0,0,0,0,0,0,0,0,1,1,3,3,4,3,1,0,0,0,0,0,0,0,0,0,0,0,0,0,0,0,0,0,0,0,0,0,0,0,0,0,0,0,0,0,0,0,1,2,2,2,1,1,1,0,0,0,0,0,0,0,0,0,1,5,8,7,5,6,9,10,9,7,7,7,7,11,14,14,11,9,7,6,6,8,13,24,24,11,0,0
0,0,0,0,0,0,0,0,0,0,0,0,4,8,5,1,0,0,0,0,1,2,2,2,2,2,2,0,0,3,5,6,6,4,2,1,1,0,0,1,0,0,0,0,0,0,0,0,0,0,0,0,0,1,1,1,1,2,3,2,0,1,2,3,2,0,1,2,1,0,0,3,9,16,17,12,9,9,9,8,9,11,14,11,10,14,18,17,10,6,7,9,8,9,19,33,31,13,0,0
0,0,0,0,0,0,0,0,0,0,0,0,7,12,9,2,1,0,0,0,0,1,1,2,3,6,7,4,2,6,8,10,9,8,5,3,2,0,1,2,1,0,0,0,0,0,0,0,0,0,0,0,0,1,2,1,0,1,2,2,1,2,4,5,4,2,3,4,2,0,1,6,14,22,23,18,14,10,6,3,6,11,16,16,16,18,24,21,15,9,10,9,8,9,16,26,24,10,0,0
0,0,0,0,0,0,0,0,0,0,0,1,5,8,6,2,1,0,0,0,0,0,0,1,2,8,11,8,3,5,6,7,6,7,6,4,2,1,1,2,1,0,0,0,0,0,0,0,0,0,0,0,0,1,1,1,0,1,2,1,1,2,4,4,4,2,3,3,1,0,2,6,11,19,23,20,13,8,4,2,5,8,13,15,18,20,23,23,23,17,13,8,8,9,11,13,11,6,0,0
0,0,0,0,0,0,0,0,0,0,1,1,1,0,0,0,0,0,0,0,0,0,0,0,0,5,8,6,2,1,1,1,1,2,3,4,3,2,1,0,0,0,0,0,0,0,0,0,0,0,0,1,0,0,0,0,0,1,1,0,1,2,2,1,2,1,1,0,0,0,3,6,4,10,18,18,10,4,2,5,10,12,12,12,15,17,18,18,23,20,15,10,11,15,14,14,10,5,0,0
0,0,0,0,0,0,0,0,0,0,1,1,1,0,0,0,0,0,0,0,0,0,0,0,0,2,3,2,0,0,1,1,1,1,1,2,3,2,0,0,0,0,0,0,0,0,0,0,0,0,0,0,0,0,0,0,1,1,0,0,0,0,1,1,1,0,0,0,0,0,3,6,4,6,11,11,6,4,3,8,14,15,10,7,10,14,15,17,20,18,14,13,14,16,15,18,15,8,0,0
0,0,0,0,0,0,0,0,0,0,1,1,0,0,0,0,0,1,0,0,0,0,0,0,0,1,1,1,0,0,0,1,2,1,1,1,1,1,0,0,0,0,0,0,0,0,0,0,0,0,0,0,0,0,0,1,2,1,0,0,0,0,0,1,0,0,0,0,0,0,3,6,4,4,6,6,8,9,9,11,14,11,7,6,8,13,17,21,19,14,11,13,12,10,10,15,16,9,0,0
0,0,0,0,0,0,0,0,0,1,1,0,0,0,0,0,0,0,0,0,0,0,0,0,1,2,2,1,0,0,0,0,0,1,1,0,0,1,1,0,0,0,0,0,0,0,0,0,0,0,0,0,0,0,0,0,1,0,0,0,0,0,1,1,0,0,0,0,0,0,4,7,7,6,7,6,13,18,18,15,15,11,9,8,9,14,21,25,21,13,10,11,10,9,9,15,16,8,0,0
0,0,0,0,0,0,0,1,2,1,0,0,0,0,0,0,0,0,0,0,1,1,0,1,2,2,1,0,0,0,0,0,0,0,1,0,0,0,1,1,0,0,0,0,0,0,0,0,0,0,0,1,1,0,0,0,0,0,0,0,0,0,1,0,0,0,0,0,0,0,5,14,19,19,19,15,21,28,31,27,24,17,15,13,13,20,27,28,22,17,16,17,18,20,21,25,23,12,0,0
0,0,0,0,0,0,0,1,2,1,0,0,0,0,0,0,0,0,0,0,0,1,1,2,2,2,0,0,0,0,0,0,0,0,1,0,0,0,0,1,1,1,1,0,0,0,0,0,0,0,0,1,1,1,0,0,0,0,0,0,0,0,0,0,0,0,0,0,0,0,7,22,30,31,29,27,29,35,39,36,30,24,22,23,24,31,35,31,24,21,21,22,26,30,29,41,41,21,0,0
0,0,0,0,0,0,0,0,1,0,0,0,0,0,0,0,0,0,0,0,0,0,1,1,1,0,0,0,0,0,0,0,0,0,1,0,0,0,0,0,0,1,2,1,0,0,0,0,0,0,0,0,1,1,0,0,0,0,0,0,0,0,0,0,0,0,0,0,0,0,9,26,36,33,28,27,27,31,32,30,24,25,29,33,37,41,41,35,30,26,28,33,38,40,37,50,52,28,0,0
0,0,0,0,0,0,0,0,0,0,0,0,0,0,0,0,0,0,0,0,0,0,1,1,0,0,0,1,0,0,0,0,0,2,2,0,0,0,0,0,0,0,1,0,0,0,0,0,0,0,0,0,0,0,0,0,0,0,0,0,0,0,0,0,0,0,0,0,0,0,12,31,35,24,19,19,19,22,21,18,17,23,27,33,38,43,41,38,35,30,33,41,46,40,34,50,54,28,0,0
0,0,0,0,0,0,0,0,0,0,0,0,0,0,0,0,0,0,0,0,0,1,1,0,0,0,0,0,0,0,0,0,1,2,2,0,0,0,0,0,0,0,0,0,0,0,0,0,0,0,0,0,0,0,0,0,0,0,0,0,0,0,1,0,0,0,0,0,0,0,12,27,28,16,14,16,16,18,20,19,15,14,16,20,29,31,31,29,30,29,32,39,43,35,24,42,50,27,0,0
0,0,0,0,1,1,0,0,0,0,0,0,0,0,0,0,0,0,1,0,0,0,0,0,0,0,0,0,0,0,0,0,1,2,1,0,0,0,0,0,0,0,0,0,0,0,0,0,0,0,0,0,0,0,0,0,0,0,0,0,0,0,1,0,0,0,0,0,0,0,7,17,15,10,15,23,24,23,26,25,19,13,15,22,22,18,15,19,25,29,28,29,29,23,15,36,47,26,0,0
0,0,0,0,1,2,0,0,0,0,0,0,0,0,0,1,0,0,0,0,0,0,0,0,0,0,0,1,0,0,0,0,1,1,0,0,0,0,0,0,0,0,0,0,0,0,0,0,0,0,0,0,0,0,0,0,0,0,0,0,0,1,2,1,0,0,0,0,0,0,6,12,16,18,21,24,37,55,65,58,45,36,35,30,22,15,16,22,28,34,32,25,21,18,13,29,38,21,0,0
0,0,0,0,1,1,0,0,1,0,0,0,1,0,0,0,0,0,0,0,0,0,0,0,0,0,0,0,0,0,0,0,1,1,0,0,0,0,0,0,0,0,0,0,0,0,0,0,0,0,0,0,0,0,0,0,0,0,0,0,0,1,2,1,0,0,0,0,0,0,31,72,75,54,58,61,74,100,118,99,71,62,61,49,30,24,34,54,71,80,86,81,73,69,68,113,129,64,0,0
0,0,0,0,0,0,0,0,0,0,0,0,0,0,0,0,0,0,0,0,0,0,0,0,0,0,0,0,0,0,0,0,0,0,0,0,0,0,0,0,0,0,0,0,0,0,0,0,0,0,0,0,0,0,0,0,0,0,0,0,0,0,1,0,0,0,0,0,0,0,47,96,99,70,68,75,75,94,105,87,59,62,72,63,44,38,47,68,82,97,108,107,102,98,100,164,167,95,0,0
0,0,0,0,0,0,0,0,0,0,0,0,0,0,0,0,0,0,0,0,0,0,0,0,0,0,0,1,2,1,0,0,0,0,0,0,0,0,0,0,0,0,0,0,0,0,0,0,0,0,0,0,0,0,0,0,0,0,0,0,0,0,0,0,0,0,0,0,0,0,25,59,56,35,39,44,36,36,40,31,22,38,59,65,50,47,47,48,47,54,61,62,60,60,61,97,108,52,0,0
0,0,0,0,0,0,0,0,0,0,0,0,0,0,0,0,0,0,0,0,0,0,0,0,0,0,0,1,2,1,0,0,0,0,0,0,0,0,0,0,0,0,0,0,0,0,0,0,0,0,0,0,0,0,0,0,0,0,0,0,0,0,0,0,0,0,0,0,0,0,0,0,0,0,0,0,0,0,0,0,8,25,43,43,41,44,41,22,3,0,0,0,0,0,0,0,0,0,0,0
0,0,0,0,0,0,0,0,0,0,0,0,0,0,0,0,0,0,0,0,0,0,0,0,0,0,0,0,1,0,0,0,0,0,0,0,0,0,0,0,0,0,0,0,0,0,0,0,0,0,0,0,0,0,0,0,0,0,0,0,0,0,0,0,0,0,0,0,0,0,0,0,0,0,0,0,0,0,0,0,12,27,35,31,28,32,36,20,4,0,0,0,0,0,0,0,0,0,0,0
0,0,0,0,0,0,0,0,0,0,0,0,0,0,0,0,0,0,0,0,0,0,0,0,0,0,0,0,0,0,0,0,0,0,0,0,0,0,0,0,0,0,0,0,0,0,0,0,0,0,0,0,0,0,0,0,0,0,0,0,0,0,0,0,0,0,0,0,0,0,0,0,0,0,0,0,0,0,0,0,15,32,38,29,27,26,27,19,7,0,0,0,0,0,0,0,0,0,0,0
0,0,0,0,0,0,0,0,0,0,0,0,0,0,0,0,0,0,0,0,0,0,0,0,0,0,0,0,0,0,0,0,0,0,0,0,0,0,0,0,0,0,0,0,0,0,0,0,0,0,0,0,0,0,0,0,0,0,0,0,0,0,0,0,0,0,0,0,0,0,0,0,0,0,0,0,0,0,1,0,11,24,31,30,27,21,24,20,10,0,0,0,0,0,0,0,0,0,0,0
0,0,0,0,0,0,0,0,0,0,0,0,0,0,0,0,0,0,0,0,0,0,0,0,0,0,0,0,0,0,0,0,0,0,0,0,0,0,0,0,0,0,0,0,0,0,0,0,0,0,0,0,0,0,0,0,0,0,0,0,0,0,0,0,0,0,1,2,1,0,0,0,0,0,0,0,0,0,1,0,5,11,21,25,25,18,19,19,12,3,0,0,0,0,0,0,0,0,0,0
0,0,0,0,0,0,0,0,0,0,0,0,0,0,0,0,0,0,0,0,0,0,0,0,0,0,0,0,0,0,0,0,0,0,0,0,0,1,0,0,0,0,0,0,0,0,0,0,0,0,0,0,0,0,0,0,0,0,0,0,0,1,1,2,2,1,2,4,2,0,0,0,0,0,0,0,0,0,1,1,2,6,14,23,25,18,16,16,15,8,2,0,0,0,0,0,0,0,0,0
0,0,0,0,0,0,0,0,0,0,0,0,0,0,0,0,0,0,0,0,0,0,0,0,0,0,0,0,0,0,0,0,0,0,0,0,1,2,1,0,0,0,0,0,0,0,0,0,0,0,0,0,0,0,0,0,0,0,0,0,0,1,2,4,4,2,3,5,2,0,0,0,0,0,0,0,0,1,1,1,3,7,13,24,27,21,13,14,15,10,4,0,0,0,0,0,0,0,0,0
0,0,0,0,0,0,0,0,0,0,0,0,0,0,0,0,0,0,0,0,0,0,0,0,0,0,0,0,0,0,0,0,0,0,0,0,1,2,1,1,1,0,0,0,0,0,0,0,0,0,0,0,0,0,0,0,0,0,0,0,1,1,1,3,4,3,3,4,2,0,0,0,0,0,0,0,0,1,2,1,4,7,11,20,26,19,12,11,12,9,6,2,0,0,0,0,0,0,0,0
0,0,0,0,0,0,0,0,0,0,0,0,0,0,0,0,0,0,0,0,0,0,0,0,0,0,0,0,0,1,1,0,0,0,0,0,0,1,1,1,1,1,0,0,1,1,1,0,0,0,0,0,0,0,0,0,0,0,0,0,1,0,0,1,2,3,4,4,2,0,0,0,0,0,0,0,1,2,2,1,3,5,10,18,23,15,9,8,9,10,9,4,1,0,0,0,0,0,0,0
0,0,0,0,0,0,0,0,0,0,0,0,0,0,0,0,0,0,0,0,0,0,0,0,0,0,0,0,1,2,2,1,1,1,1,0,0,0,0,0,1,1,0,0,0,3,4,2,0,0,0,0,0,0,0,0,0,0,0,0,1,0,0,0,2,3,5,4,2,0,0,0,0,0,0,1,1,1,2,1,2,5,10,18,21,14,7,5,8,10,12,8,3,0,0,0,0,0,0,0
0,0,0,0,0,0,0,0,0,0,0,0,0,0,0,0,0,0,0,0,0,0,0,0,0,0,0,0,0,1,1,0,0,0,0,0,0,0,0,0,0,0,0,0,0,3,5,3,0,0,0,0,0,0,0,0,0,0,0,1,1,0,0,1,2,3,6,5,2,0,0,0,0,0,0,1,2,1,1,1,2,4,10,16,20,15,9,4,6,9,11,9,4,1,0,0,0,0,0,0
0,0,0,0,0,0,0,0,0,0,0,0,0,0,0,0,0,0,0,1,1,0,0,0,0,0,0,0,0,0,0,0,0,0,0,0,0,0,0,1,1,0,0,0,0,3,4,2,0,0,0,0,0,0,0,0,0,0,1,1,1,0,0,1,2,3,5,5,2,0,0,0,0,0,1,1,1,1,0,0,2,5,11,16,20,18,12,5,5,7,10,9,4,1,0,0,0,0,0,0
0,0,0,0,0,0,0,0,0,0,0,0,0,0,0,0,0,0,1,2,2,1,0,0,1,0,0,0,0,0,0,0,0,0,0,0,0,0,0,1,1,1,1,1,1,2,3,2,1,1,1,1,1,1,1,1,0,0,1,1,0,0,1,2,2,3,5,3,1,0,0,0,0,1,2,1,1,2,1,1,3,5,11,15,21,19,15,7,5,7,8,7,4,2,0,0,0,0,0,0
0,0,0,0,0,0,0,0,0,0,0,0,0,0,0,0,0,0,0,1,1,0,0,0,0,0,0,0,0,1,0,0,0,0,1,0,0,0,1,1,1,1,0,1,1,3,3,2,2,2,1,1,1,2,2,1,0,0,0,0,0,1,3,3,2,3,6,5,2,0,0,0,1,2,3,2,2,2,3,3,4,4,9,13,19,19,14,6,5,6,9,8,5,2,0,0,0,0,0,0
0,0,0,0,0,0,0,0,0,0,0,0,0,0,0,0,0,0,0,0,0,0,0,0,0,0,0,0,0,1,1,0,0,0,1,0,0,1,1,1,1,0,0,0,1,2,3,2,3,2,2,1,0,1,1,0,0,0,0,0,0,1,3,3,2,2,7,8,4,0,0,1,2,2,2,3,3,3,4,5,4,3,8,10,17,17,12,5,4,6,8,9,6,3,0,0,0,0,0,0
0,0,0,0,0,0,0,0,0,0,0,0,0,0,0,0,0,0,0,0,0,0,0,0,0,0,0,1,1,1,1,1,0,0,1,0,0,1,1,1,0,0,0,0,1,2,2,3,3,2,2,1,1,1,0,0,0,1,0,0,2,2,2,2,2,1,6,8,6,1,1,3,4,2,1,2,3,3,7,8,7,5,7,10,16,16,10,3,3,4,7,9,7,3,0,0,0,0,0,0
0,0,0,0,0,0,0,0,0,0,0,0,0,0,0,0,0,0,0,0,0,0,0,0,0,0,1,2,1,0,0,0,0,0,0,0,0,1,1,0,0,0,0,0,1,2,2,3,3,3,2,1,1,2,2,1,2,2,1,2,4,4,3,3,4,3,5,6,6,4,4,5,5,3,1,2,2,4,10,12,10,7,8,9,15,17,11,5,4,5,8,10,7,3,1,0,0,0,0,0
0,0,0,0,0,0,0,0,0,0,0,0,0,0,0,0,0,0,0,0,0,0,0,0,0,0,0,1,0,0,0,0,0,0,0,0,0,1,0,0,0,0,0,0,1,2,1,1,1,1,1,0,0,2,3,3,3,3,1,2,4,5,5,5,5,4,4,5,7,7,5,4,4,2,3,4,3,4,9,11,9,8,9,9,15,18,15,7,6,5,10,12,8,4,2,0,0,0,0,0
0,0,0,0,0,0,0,0,0,0,0,0,0,0,0,0,0,0,0,0,0,0,0,0,0,0,0,0,0,0,0,0,0,0,0,0,0,0,0,0,0,0,0,0,1,2,1,0,0,0,0,0,0,1,2,2,2,1,1,0,2,4,5,5,5,4,4,5,7,7,5,4,3,2,3,4,3,4,6,7,7,8,10,9,15,19,16,8,6,7,11,12,10,6,4,1,0,0,0,0
0,0,0,0,0,0,0,0,1,0,0,0,0,0,0,0,0,0,0,0,0,0,0,0,0,0,0,0,0,0,0,0,0,0,0,0,0,1,0,0,0,0,0,0,1,3,1,0,0,0,0,0,1,0,0,0,0,0,0,0,1,2,3,3,3,3,4,5,5,4,4,4,4,3,3,4,4,4,4,8,9,8,9,10,14,17,14,7,6,7,10,9,8,7,5,2,1,0,0,0
0,0,0,0,0,0,0,1,2,1,0,0,0,0,0,0,0,0,0,0,0,0,0,0,0,0,0,1,1,0,0,1,0,0,1,0,1,2,1,0,0,1,1,0,2,3,2,0,0,0,0,0,0,0,0,0,0,0,0,1,1,1,2,3,2,3,5,6,3,2,3,5,5,3,2,2,3,3,4,9,10,9,9,11,14,16,13,7,5,6,8,8,8,7,4,2,1,0,0,0
0,0,0,0,0,0,0,0,1,1,1,0,0,0,0,0,0,0,0,0,0,0,0,0,0,0,2,2,1,0,0,0,0,0,0,0,1,2,1,0,0,1,1,0,1,3,1,0,0,0,0,0,0,0,0,0,0,1,2,2,1,2,3,4,3,3,5,8,9,7,7,6,5,2,1,1,2,1,3,6,8,10,13,15,16,17,15,11,6,7,9,9,8,8,5,4,3,1,0,0
0,0,0,0,0,0,0,0,0,0,0,0,0,1,0,0,0,0,0,0,0,0,0,0,0,1,2,2,1,0,0,0,0,0,0,0,0,1,0,0,0,1,1,0,1,3,1,0,0,0,0,0,0,0,0,0,0,1,2,2,2,4,4,4,3,4,6,10,11,11,8,6,2,0,0,0,0,0,1,4,5,10,15,18,18,21,19,15,11,12,12,11,9,9,7,7,6,3,0,0
0,0,0,0,0,0,0,0,0,0,0,0,0,0,0,0,0,0,0,0,0,0,0,0,0,0,1,0,0,0,0,0,0,0,0,0,0,0,1,1,1,1,0,0,1,3,3,0,0,0,0,0,0,0,0,0,0,0,1,2,2,3,3,3,3,6,9,10,7,6,5,4,1,0,0,1,1,1,2,4,5,10,15,17,19,22,22,18,15,15,15,12,9,8,7,10,10,5,0,0
0,0,0,0,0,0,0,0,0,0,0,0,0,0,0,0,0,1,0,0,0,0,0,0,0,0,0,0,0,0,0,0,0,0,0,0,0,0,2,2,1,0,0,0,0,4,5,3,0,0,0,0,0,0,0,0,0,0,1,2,2,1,2,2,4,7,9,7,3,0,2,4,4,2,2,1,2,3,4,4,5,9,14,15,18,21,20,14,12,14,15,13,11,9,7,10,10,5,0,0
0,0,0,0,0,0,0,0,0,0,0,0,0,0,0,0,0,0,0,0,0,0,0,1,0,0,0,0,1,0,0,0,0,0,0,1,1,2,3,2,0,0,0,0,0,3,5,3,0,0,0,0,0,0,0,0,0,0,1,2,1,0,1,1,3,5,8,8,4,0,2,6,6,4,3,2,4,6,8,8,9,12,15,12,13,19,19,13,12,13,13,13,11,8,5,9,11,5,0,0
0,0,0,0,0,0,0,0,0,0,0,0,0,0,0,0,0,0,0,0,0,0,0,1,0,0,0,0,1,1,0,0,0,0,1,1,1,2,2,0,0,0,0,0,0,1,2,1,0,0,0,0,0,0,0,0,0,0,1,3,3,2,3,2,1,2,7,8,5,0,1,3,5,5,5,3,6,9,13,13,14,16,17,11,9,17,20,16,12,12,9,11,12,8,3,7,9,5,0,0
0,0,0,0,0,0,0,0,0,0,0,0,0,0,1,1,0,1,1,0,0,0,0,1,0,0,0,0,0,1,0,0,0,0,1,0,0,1,1,0,0,1,1,0,0,3,4,2,0,0,0,0,0,0,0,1,1,0,2,5,5,6,5,3,2,3,14,18,10,0,6,21,30,27,24,22,18,20,26,28,25,23,21,13,10,20,25,24,25,33,41,49,45,30,16,32,40,21,0,0
0,0,0,0,0,0,0,0,0,0,0,0,0,1,2,2,1,1,0,0,0,0,0,0,0,0,0,0,0,0,0,0,0,0,0,0,0,0,0,1,1,1,1,0,0,5,6,4,0,0,0,0,0,0,1,2,2,1,2,5,6,6,4,3,1,3,16,20,12,0,11,33,45,40,33,31,24,25,28,34,31,30,23,18,18,25,35,41,46,49,59,69,59,41,25,48,51,31,0,0
0,0,0,0,0,0,0,0,0,0,0,0,0,0,1,1,0,0,0,0,0,0,0,0,0,0,0,0,0,0,0,0,0,0,0,0,0,0,0,0,0,0,0,0,0,3,4,2,0,0,0,0,0,0,0,1,1,0,1,2,3,2,1,0,0,1,8,12,6,0,6,21,28,23,19,19,14,13,15,21,25,26,21,21,24,31,43,52,46,37,36,41,34,22,15,27,33,17,0,0
0,0,0,0,0,0,0,0,0,0,0,0,0,0,0,0,0,0,0,0,0,0,0,0,0,0,0,0,0,0,0,0,0,0,0,0,0,0,0,0,0,0,0,0,0,0,0,0,0,0,0,0,0,0,0,0,0,0,0,0,0,0,0,0,0,0,0,0,0,0,0,0,0,0,0,0,0,0,0,2,9,14,15,17,20,27,36,37,24,6,0,0,0,0,0,0,0,0,0,0
0,0,0,0,0,0,0,0,0,0,0,0,0,0,0,0,0,0,0,0,0,0,0,0,0,0,0,0,0,0,0,0,0,0,0,0,0,0,0,0,0,0,0,0,0,0,0,0,0,0,0,0,0,0,0,0,0,0,0,0,0,0,0,0,0,0,0,0,0,0,0,0,0,0,0,0,0,0,0,0,2,5,8,8,10,14,19,14,4,0,0,0,0,0,0,0,0,0,0,0
