0,0,0,0,0,0,0,0,0,0,0,0,0,0,0,0,0,0,0,0,0,0,0,0,0,0,0,0,0,0,0,0,0,0,0,0,0,0,0,0,0,0,0,0,0,0,0,0,0,0,0,0,0,0,0,0,0,0,0,0,0,0,0,0,0,0,0,0,0,0,0,0,0,0,0,0,0,0,0,0,0,0,0,0,0,0,0,0,0,0,0,0,0,0,0,0,0,0,0,0
0,0,0,0,0,0,0,0,0,0,0,0,0,0,0,0,0,0,0,0,0,0,0,0,0,0,0,0,0,0,0,0,0,0,0,0,0,0,0,0,0,0,0,0,0,0,0,0,0,0,0,0,0,0,0,0,0,0,0,0,0,0,0,0,1,3,6,6,2,0,0,0,0,0,0,0,0,0,0,0,0,0,0,0,0,0,0,0,0,0,0,0,0,0,0,0,0,0,0,0
0,0,0,0,0,0,0,0,0,0,0,0,0,0,0,0,0,0,0,0,0,0,0,0,0,0,0,0,0,0,0,0,0,0,0,0,0,0,0,0,0,0,0,0,0,0,0,0,0,0,0,0,0,0,0,0,0,0,0,0,0,1,0,1,2,6,11,11,5,0,0,0,0,0,0,0,0,0,0,0,0,0,0,0,0,0,0,0,0,0,0,0,0,0,0,0,0,0,0,0
0,0,0,0,0,0,0,0,0,0,0,0,0,0,0,0,0,0,0,0,0,0,0,0,0,0,0,0,0,0,0,0,0,0,0,0,0,0,0,0,0,0,0,0,0,0,0,0,0,0,0,0,0,0,0,0,0,0,0,0,0,0,0,2,2,5,10,10,4,0,0,0,0,0,0,0,0,0,0,0,0,0,0,0,0,0,0,0,0,0,0,0,0,0,0,0,0,0,0,0
0,0,0,0,0,0,0,0,0,0,0,1,0,0,0,0,0,0,0,0,0,0,0,0,0,0,0,0,0,0,0,0,0,0,0,0,0,0,0,0,0,0,0,0,0,0,0,0,0,0,0,0,0,0,0,0,0,0,0,0,0,0,0,1,1,3,6,5,2,0,0,0,0,0,0,0,0,0,0,0,0,0,0,0,0,0,0,0,0,0,0,0,0,0,0,0,0,0,0,0
0,0,0,0,0,0,0,0,0,0,1,2,1,0,0,0,0,0,0,0,0,0,0,0,0,0,0,0,0,0,0,0,0,0,0,0,0,0,0,0,0,0,0,0,0,0,0,0,0,0,0,0,0,0,0,0,0,0,0,0,0,0,0,1,2,3,7,8,4,0,0,0,0,0,0,0,0,0,0,0,0,0,0,0,0,0,0,0,0,0,0,0,0,0,0,0,0,0,0,0
0,0,0,0,0,0,0,0,0,0,0,1,0,0,1,0,0,0,0,0,0,0,0,0,0,0,0,0,0,0,0,0,0,0,0,0,0,0,0,0,0,0,0,0,0,0,0,0,0,0,0,0,0,0,0,0,0,0,0,0,0,0,1,1,4,6,11,11,6,0,0,0,0,0,0,0,1,1,1,1,1,0,0,0,0,0,0,0,0,0,0,0,0,0,0,0,0,0,0,0
0,0,0,0,0,0,0,1,1,0,0,0,0,0,0,0,0,0,0,1,0,0,0,0,1,0,0,0,0,0,0,0,0,0,0,0,0,0,0,0,0,0,0,0,0,0,0,0,0,0,0,0,0,0,0,0,0,0,0,0,0,1,1,2,4,6,11,10,5,0,0,0,0,1,1,1,1,1,0,1,1,0,0,0,0,0,0,0,0,0,0,0,0,0,0,0,0,0,0,0
0,0,0,0,0,0,0,1,1,0,0,0,0,0,0,0,0,0,0,0,0,0,0,0,0,0,0,0,0,1,0,0,0,0,0,0,0,0,0,0,0,0,0,0,0,0,1,0,0,0,0,0,0,0,0,0,0,0,0,0,1,2,3,3,4,4,7,6,3,0,0,0,1,2,3,3,2,1,0,0,1,1,0,0,0,0,0,0,0,0,0,0,0,0,0,0,0,0,0,0
0,0,0,0,0,0,0,1,1,1,0,0,0,0,0,0,0,0,0,0,0,0,0,0,0,0,0,0,0,0,0,0,0,0,0,1,0,0,0,0,0,0,1,0,0,1,2,1,0,0,0,0,0,0,0,0,0,0,0,0,2,3,3,3,3,2,3,3,2,0,0,1,2,3,4,5,4,3,2,1,0,1,1,1,1,0,0,0,0,0,0,0,0,0,0,0,0,0,0,0
0,0,0,0,0,0,0,0,0,1,0,0,0,0,0,0,0,0,0,0,0,0,0,0,0,0,0,0,0,0,0,0,0,0,0,0,0,0,0,0,1,1,0,0,0,0,1,1,1,1,1,0,0,0,0,1,1,0,0,0,1,2,2,2,2,1,3,5,8,9,6,2,2,2,3,5,4,4,4,3,1,0,0,1,1,0,0,0,0,0,0,0,0,0,0,0,0,0,0,0
0,0,0,0,0,0,0,0,0,0,0,0,0,0,0,0,0,0,0,0,0,0,0,0,0,0,0,0,0,0,0,0,0,0,0,0,0,0,0,1,2,2,0,0,0,0,1,1,2,1,1,0,1,1,1,1,1,1,1,2,1,1,1,1,1,1,4,8,16,16,12,5,2,2,2,2,2,4,5,4,2,1,1,0,1,1,0,0,0,0,0,0,0,0,0,0,0,0,0,0
0,0,0,0,0,0,0,0,0,0,0,0,0,1,0,0,0,0,0,0,0,0,0,0,0,0,0,0,0,0,0,0,0,0,0,0,0,0,0,0,2,2,2,0,0,0,1,1,1,0,0,0,1,2,1,1,0,1,3,3,2,2,3,3,3,4,7,12,16,15,11,6,3,2,2,2,1,3,5,5,3,2,2,1,2,2,1,0,0,0,0,0,0,0,0,0,0,0,0,0
0,0,0,0,0,0,0,0,0,0,0,0,0,0,0,0,0,0,0,0,0,0,0,0,0,0,0,0,0,0,0,0,0,0,0,0,1,1,0,0,0,2,2,1,0,0,0,1,0,0,0,0,1,2,2,1,0,0,1,2,3,4,5,5,5,6,9,12,10,6,5,6,4,2,2,1,1,1,4,5,5,4,3,2,2,2,1,1,0,0,0,0,0,0,0,0,0,0,0,0
0,0,0,0,0,0,0,0,0,0,0,0,0,0,0,0,0,0,0,0,0,0,0,0,0,0,0,0,0,0,0,1,0,0,0,1,1,1,1,0,0,0,1,1,1,0,0,1,0,0,1,0,1,2,2,2,1,1,1,3,4,5,5,5,5,7,10,11,7,5,4,5,5,5,4,3,1,1,3,4,5,5,4,3,1,1,1,1,0,0,0,0,0,0,0,0,0,0,0,0
0,0,0,0,0,0,0,0,0,0,0,0,0,0,0,0,1,0,0,0,0,0,0,0,0,0,0,1,0,0,0,1,1,0,0,1,0,0,0,0,0,0,0,0,0,0,0,0,0,0,0,0,0,1,2,1,1,2,4,6,6,3,3,3,5,7,8,8,6,6,5,5,5,8,10,7,4,3,3,3,3,5,5,4,1,1,1,2,1,0,0,0,0,0,0,0,0,0,0,0
0,0,0,0,0,0,0,0,0,0,0,0,0,0,0,0,0,0,0,0,0,1,1,0,0,0,0,0,0,0,0,0,1,0,0,0,0,0,0,0,0,0,0,0,0,0,0,0,0,0,0,0,0,0,0,0,1,3,5,5,4,3,3,2,4,6,8,11,13,11,7,5,4,8,10,8,5,4,4,4,5,7,8,6,1,0,1,2,2,2,0,0,0,0,0,0,0,0,0,0
0,0,0,0,0,0,0,0,0,0,0,0,0,0,0,0,0,0,0,0,0,1,1,0,0,0,0,0,2,1,0,0,0,0,0,0,0,0,0,0,0,0,0,0,0,0,0,0,0,0,0,0,0,0,0,0,1,3,4,2,2,3,3,1,3,6,9,14,15,11,6,3,2,3,4,3,3,3,3,4,6,8,9,6,3,1,0,1,2,2,1,0,0,0,0,0,0,0,0,0
0,0,0,0,0,0,0,0,0,0,0,0,0,0,0,0,0,0,0,0,0,1,1,0,0,0,0,1,2,2,0,0,0,0,0,0,0,0,0,0,0,0,0,0,0,0,0,0,0,0,0,0,0,0,0,0,1,2,2,1,1,2,2,1,3,7,10,11,10,6,3,1,1,1,0,0,0,1,1,1,3,6,8,8,5,2,0,0,1,2,1,0,0,0,0,0,0,0,0,0
0,0,0,0,0,0,0,0,0,0,0,0,0,0,0,0,0,0,1,0,0,0,0,0,0,0,1,1,1,0,0,0,0,0,0,0,0,0,0,1,1,0,0,0,0,0,0,0,0,0,0,0,0,1,0,0,0,2,2,1,0,0,0,1,4,8,10,7,3,0,0,0,1,0,0,0,0,0,0,0,0,1,6,8,8,4,2,0,0,1,1,1,0,0,0,0,0,0,0,0
0,0,0,0,0,0,0,0,0,0,0,0,0,0,0,0,0,0,0,0,0,0,0,0,0,0,0,0,0,0,0,0,0,0,1,0,0,0,1,2,2,0,0,0,0,0,1,1,0,0,1,0,0,0,0,0,0,2,3,2,0,0,2,2,4,6,9,8,4,0,0,0,1,1,0,0,0,0,0,0,0,0,3,7,7,5,3,1,0,1,2,1,0,0,0,0,0,0,0,0
0,0,0,0,0,0,0,0,0,0,0,0,0,0,1,0,0,0,0,0,0,0,0,0,0,0,0,0,0,0,0,0,0,0,0,0,0,0,0,1,1,0,1,1,1,1,1,0,0,0,1,1,0,0,0,0,0,1,2,2,1,1,2,2,3,5,12,14,7,0,0,0,0,1,0,0,0,0,0,0,0,0,1,5,7,7,4,2,2,3,2,0,0,0,0,0,0,0,0,0
0,0,0,0,0,0,0,0,0,0,0,0,1,1,0,0,0,0,0,0,0,0,0,0,0,0,0,0,1,1,1,0,0,0,0,0,0,0,0,0,0,0,1,1,0,0,0,0,0,0,0,1,0,0,0,0,0,0,1,2,2,1,1,1,2,4,16,21,12,0,0,0,0,0,0,0,0,0,0,0,0,0,0,2,6,7,6,2,3,3,2,0,1,0,0,0,0,0,0,0
0,0,0,0,0,0,0,0,0,0,0,1,2,1,0,0,0,0,0,0,0,0,0,0,1,1,0,0,0,0,0,0,0,0,0,0,0,0,0,0,0,0,0,0,0,0,0,0,0,0,0,1,0,0,1,1,1,1,1,1,1,0,0,1,2,3,16,23,13,0,0,0,0,0,0,0,0,0,0,0,0,0,0,1,4,5,5,2,1,1,0,1,2,1,0,0,0,0,0,0
0,0,0,0,0,0,0,0,0,0,0,0,1,0,0,0,0,0,0,0,0,0,0,1,1,0,0,0,0,0,0,0,0,0,0,0,0,1,0,0,0,0,0,0,0,0,0,0,0,0,0,1,0,0,1,1,0,1,1,1,1,0,0,1,1,1,11,16,9,0,0,0,0,1,0,0,0,0,0,0,0,0,0,1,1,3,5,4,2,1,1,1,1,0,0,0,0,0,0,0
0,0,0,0,0,0,0,0,0,0,0,0,0,0,0,0,0,0,0,0,1,1,0,0,0,0,0,0,0,0,0,0,0,0,0,1,1,1,1,1,1,1,1,0,0,0,0,0,1,0,0,2,2,1,1,1,0,0,1,2,2,1,0,0,0,0,8,13,7,0,0,0,0,0,0,0,0,0,0,0,0,0,0,0,0,4,8,6,3,2,1,0,0,0,0,0,0,0,0,0
0,0,0,0,0,0,0,0,0,0,0,0,0,0,0,0,0,0,0,1,2,2,0,0,0,0,0,0,0,0,0,0,0,0,0,1,1,2,2,2,1,2,1,0,1,1,1,1,1,0,0,2,2,1,0,1,0,0,1,2,2,1,1,1,2,2,13,17,10,0,0,0,0,0,0,0,0,0,0,0,0,0,0,0,1,5,8,7,3,2,1,0,1,1,1,0,0,0,0,0
0,0,0,0,0,0,0,0,0,0,0,0,0,0,0,0,0,0,0,0,1,1,0,0,0,0,0,0,0,0,0,0,0,0,0,1,1,1,1,1,1,1,1,0,1,1,1,1,0,0,0,1,1,0,0,0,0,0,0,0,0,0,1,2,3,3,13,16,10,0,0,0,0,0,1,0,0,0,0,0,0,0,0,0,1,4,6,5,3,2,0,0,1,1,1,0,0,0,0,0
0,0,0,0,0,0,0,0,0,0,0,0,0,0,0,0,0,0,0,0,0,0,0,0,0,0,0,0,0,0,0,0,0,0,0,0,0,0,0,0,0,0,0,0,0,0,0,0,0,0,0,0,0,0,0,0,0,0,0,0,0,0,0,1,2,2,6,8,4,0,0,0,0,0,0,0,0,0,0,0,0,0,0,0,2,3,4,5,4,2,1,0,0,1,0,0,0,0,0,0
0,0,0,0,0,0,0,0,0,0,0,0,0,0,0,0,0,0,0,0,0,0,0,0,0,0,0,0,0,0,0,0,0,0,0,0,0,0,0,0,0,0,0,0,0,0,0,0,0,0,0,0,0,0,0,0,0,0,0,0,0,0,0,0,0,0,0,0,0,0,0,0,0,0,0,0,0,0,0,0,0,0,0,1,2,4,6,5,3,2,1,0,1,1,1,0,0,0,0,0
0,0,0,0,0,0,0,0,0,0,0,0,0,0,0,0,0,0,0,0,0,0,0,0,0,0,0,0,0,0,0,0,0,0,0,0,0,0,0,0,0,0,0,0,0,0,0,0,0,0,0,0,0,0,0,0,0,0,0,0,0,0,0,0,0,0,0,0,0,0,0,0,0,0,0,1,0,0,0,0,0,0,0,1,2,4,5,5,3,3,1,0,1,2,1,0,0,0,0,0
0,0,0,0,0,0,0,0,0,0,0,0,0,0,0,0,0,0,0,0,0,0,1,1,0,0,0,1,0,0,1,0,0,0,0,0,0,0,0,0,0,0,0,0,0,0,0,0,0,0,0,0,0,0,0,0,0,0,0,0,0,0,0,2,3,2,0,0,0,0,0,0,0,0,0,0,0,0,0,0,0,0,0,2,2,2,3,3,3,2,1,0,0,1,1,0,0,0,0,0
0,0,0,0,0,0,0,0,0,0,0,0,0,0,0,0,0,0,0,0,0,1,1,0,0,0,0,0,0,0,0,0,0,0,0,0,0,1,0,0,0,0,0,0,0,0,0,0,0,0,0,0,0,0,0,0,0,0,0,0,0,0,0,4,5,3,0,0,0,0,0,0,0,0,0,0,0,0,0,0,0,0,0,2,3,3,3,2,2,2,2,1,1,1,1,0,0,0,0,0
0,0,0,0,0,0,0,0,0,0,0,1,1,0,0,0,0,0,0,0,0,0,0,0,0,0,0,0,0,0,0,0,0,0,0,0,0,0,0,0,0,0,0,0,0,1,0,0,0,0,0,0,0,0,0,0,0,0,0,0,0,0,1,3,4,3,0,0,0,0,0,0,0,0,0,0,1,1,1,1,0,0,0,1,2,4,5,4,1,1,2,2,2,1,1,1,0,0,0,0
0,0,0,0,0,0,0,0,0,0,1,2,2,1,0,0,0,0,1,1,0,0,0,0,0,0,0,0,0,0,0,0,0,0,0,0,0,0,0,0,0,0,0,0,0,0,0,0,0,0,0,0,0,0,0,0,0,0,0,0,0,0,0,0,1,1,0,0,0,0,0,0,0,0,0,0,1,1,0,0,0,0,0,1,2,4,5,5,3,3,3,2,2,1,1,1,0,0,0,0
0,0,0,0,0,0,1,1,0,0,0,1,1,0,0,0,0,1,1,1,1,0,0,0,0,0,0,0,1,1,1,1,1,1,1,0,0,1,0,0,0,0,0,0,0,0,0,1,0,0,0,0,0,0,0,0,0,0,0,0,0,0,0,0,0,1,1,0,0,0,0,0,0,0,0,0,0,0,0,0,0,0,0,1,2,2,4,4,4,4,3,3,2,2,1,1,0,0,0,0
0,0,0,0,0,1,1,1,0,0,0,0,0,0,0,0,0,1,1,1,1,0,1,1,1,1,1,1,2,1,1,1,1,1,0,0,1,2,1,0,1,1,1,0,0,0,1,2,1,0,0,1,0,0,0,0,0,0,0,0,0,0,0,0,0,0,1,0,0,0,0,0,1,0,0,0,0,0,0,0,0,0,0,1,2,3,3,3,4,4,4,4,2,1,1,1,0,0,0,0
0,0,0,0,0,1,1,0,0,0,0,0,0,0,0,0,0,0,1,1,0,0,1,2,2,2,2,2,1,1,0,0,1,1,0,0,0,1,0,0,1,1,1,0,1,1,2,2,1,0,0,0,0,0,0,0,0,0,0,0,0,0,1,0,0,0,1,1,1,0,0,0,0,0,0,0,0,0,1,0,0,0,0,0,1,2,3,3,2,2,3,4,1,0,2,1,0,0,0,0
0,0,0,0,0,0,1,1,0,0,0,0,0,0,0,0,0,0,0,0,0,1,1,1,2,2,1,1,0,0,0,0,0,1,0,0,0,0,1,1,1,1,0,0,1,2,2,1,1,1,1,0,0,0,1,0,0,0,0,0,0,0,0,0,0,0,0,1,1,0,0,0,0,0,0,0,0,0,0,0,0,0,0,0,1,3,2,1,2,2,3,3,2,0,1,1,0,0,0,0
0,0,0,0,0,0,0,1,1,0,0,0,0,0,0,0,0,0,0,0,2,3,2,1,1,1,0,0,0,0,1,0,0,1,1,1,0,0,1,1,1,1,0,0,1,1,1,0,1,2,2,1,1,2,3,1,1,1,1,0,0,0,0,0,0,1,2,2,1,1,1,0,0,1,1,0,0,0,0,0,0,0,0,0,1,3,3,2,2,1,2,3,2,1,1,1,0,0,0,0
0,0,0,0,0,0,0,0,1,1,1,0,0,0,0,0,0,1,1,1,2,3,2,0,0,0,0,0,1,1,0,0,0,0,1,1,0,0,1,1,0,0,0,0,0,1,1,0,1,2,2,2,2,3,3,2,2,2,1,0,0,0,1,1,0,2,3,2,1,2,2,1,1,1,1,1,1,1,1,2,1,0,0,1,1,3,4,3,2,1,1,3,2,2,2,1,1,0,0,0
0,0,0,0,0,0,0,0,0,0,1,1,0,0,1,1,0,1,1,2,2,1,0,0,0,0,0,1,2,1,1,1,0,1,1,1,1,0,0,0,0,0,0,0,0,0,1,0,0,1,1,1,1,2,2,2,2,2,3,3,4,3,3,2,1,2,3,3,1,1,1,1,2,1,1,1,1,0,2,3,2,1,1,1,0,2,4,4,2,1,1,3,3,2,2,1,0,0,0,0
0,0,0,0,0,0,0,0,0,0,0,0,0,1,2,2,1,1,1,2,1,0,0,0,0,0,0,1,2,1,2,2,1,1,0,0,1,0,0,1,3,2,0,0,0,1,1,0,0,0,0,0,0,1,1,1,1,1,4,5,5,4,3,3,2,2,2,2,2,1,0,1,2,2,1,1,1,1,1,2,3,3,3,2,1,2,4,4,2,0,1,3,3,1,1,0,0,0,0,0
0,0,0,0,0,0,0,0,0,0,0,0,0,1,2,1,1,1,1,1,1,1,0,0,0,0,1,1,1,1,1,2,1,0,0,0,0,0,0,2,3,3,1,1,1,2,1,0,0,0,0,0,0,0,0,0,0,1,3,3,3,2,4,5,4,1,1,2,2,1,0,0,1,1,0,0,3,4,3,1,2,3,3,2,1,2,4,5,4,2,1,3,2,1,0,2,3,1,0,0
0,0,0,0,0,0,0,0,0,0,0,0,0,0,1,0,0,0,1,2,1,1,1,0,0,1,2,2,1,0,0,1,1,0,0,0,0,1,1,1,2,2,1,1,1,1,1,0,1,1,1,1,0,0,0,0,1,2,2,0,0,1,3,4,3,0,1,2,2,1,0,0,0,1,0,0,5,8,7,3,3,3,2,2,1,2,4,7,6,3,2,3,2,0,2,5,4,1,0,0
0,0,0,0,0,0,0,0,0,0,0,0,0,0,1,1,0,0,1,2,2,0,0,0,0,1,2,2,0,0,0,0,1,0,0,1,1,2,2,1,1,1,1,1,1,1,1,1,2,2,2,2,2,2,1,1,3,4,2,0,1,3,3,2,1,0,2,3,4,2,2,2,1,1,1,0,4,9,9,6,5,3,2,2,3,3,4,6,6,3,3,3,2,0,4,6,6,2,0,0
0,0,0,0,0,0,0,0,0,0,0,0,0,0,1,1,0,0,1,2,1,0,0,1,1,1,1,1,0,0,0,0,0,0,0,0,1,2,2,2,1,1,2,2,1,1,1,2,2,2,3,3,3,4,3,3,6,6,3,1,2,4,3,1,0,0,1,3,4,3,4,3,3,1,1,1,4,7,8,7,6,5,4,4,4,3,4,6,4,3,4,4,2,1,4,8,6,2,0,0
0,0,0,0,0,0,0,0,0,0,0,0,0,0,0,0,0,0,0,2,3,2,2,2,1,0,0,0,0,0,0,0,0,0,0,0,0,0,0,1,1,1,2,2,1,0,1,2,1,1,2,2,2,3,2,3,6,6,3,1,2,4,4,1,0,0,0,1,2,2,3,3,2,2,2,3,6,6,6,5,6,5,4,4,4,5,6,5,3,3,4,6,4,2,3,7,7,3,0,0
0,0,0,0,0,0,0,0,0,0,0,0,0,0,0,0,0,0,1,2,4,4,3,3,1,0,0,0,0,0,0,0,0,0,0,0,0,0,0,0,0,0,1,1,0,0,0,0,0,0,1,1,0,1,1,2,3,4,2,1,1,2,3,1,0,0,0,0,0,1,1,0,1,1,1,3,5,4,3,5,7,7,6,5,3,4,7,7,3,2,5,7,6,3,3,7,7,4,0,0
0,0,0,0,0,0,0,0,0,0,0,0,0,0,0,0,0,0,1,1,3,4,3,2,1,0,0,0,0,0,0,0,0,0,0,0,0,0,0,0,0,0,0,0,0,0,0,0,0,0,0,0,0,0,0,1,1,1,0,0,1,4,5,3,0,0,0,0,0,0,0,0,0,0,0,1,2,3,4,5,6,7,7,7,4,3,6,7,5,2,3,6,6,5,5,8,7,4,0,0
0,0,0,0,0,0,0,0,0,0,0,0,0,0,0,0,0,1,1,0,2,3,4,2,1,0,0,0,0,0,0,0,0,0,0,0,0,0,0,0,0,0,0,0,0,0,0,0,0,0,0,0,0,0,0,0,0,0,0,0,1,4,5,3,0,0,0,0,0,0,0,0,2,2,1,1,1,4,6,6,3,4,6,8,6,4,5,7,6,4,3,5,4,5,6,10,9,5,0,0
0,0,0,0,0,0,0,0,0,0,0,1,3,4,2,0,0,1,0,0,1,3,3,2,1,0,0,0,1,2,2,2,4,3,1,1,1,0,0,0,0,0,0,0,0,0,0,0,0,0,0,0,0,1,1,0,0,0,0,0,0,2,3,3,1,1,2,3,1,0,0,1,3,4,3,3,3,6,9,8,5,4,6,7,7,8,9,10,9,9,9,8,4,6,9,13,11,5,0,0
0,0,0,0,0,0,0,0,0,0,0,1,5,6,4,0,0,0,0,0,0,1,2,2,2,2,1,1,3,4,3,4,6,6,3,3,2,0,0,0,0,0,0,0,0,0,0,0,0,0,0,1,1,1,1,1,1,0,0,0,0,0,2,2,2,2,6,8,4,0,0,0,2,3,4,4,5,6,8,8,8,5,5,6,8,10,13,14,14,13,14,11,7,9,13,15,12,6,0,0
0,0,0,0,0,0,0,0,0,0,0,1,3,4,2,0,0,0,0,0,0,0,1,1,3,5,7,4,3,3,2,2,4,4,3,2,2,1,0,0,0,0,0,0,0,0,0,0,0,0,0,0,0,1,1,0,1,1,1,0,0,1,1,1,1,1,6,8,5,0,1,4,6,4,4,6,6,5,4,5,6,5,4,6,9,12,14,16,14,12,14,17,14,12,13,14,11,5,0,0
0,0,0,0,0,0,0,0,0,0,0,1,0,0,0,0,0,0,0,0,0,0,0,1,2,7,10,9,3,1,0,0,1,1,2,1,1,1,0,0,0,0,0,0,0,0,0,0,0,0,0,0,0,0,0,0,1,2,2,1,1,1,1,0,0,0,2,3,2,0,3,11,15,10,5,6,6,4,2,2,4,5,4,5,8,11,11,13,11,10,14,21,18,12,8,12,12,6,0,0
0,0,0,0,0,0,0,0,0,0,1,1,0,0,0,0,0,0,0,0,0,0,0,0,1,3,8,8,4,0,0,0,1,2,3,2,0,0,0,0,0,0,0,0,0,0,0,0,0,0,0,0,0,0,0,0,2,2,1,0,0,0,0,0,0,0,0,0,0,0,6,17,20,14,9,9,7,5,3,3,5,8,10,7,6,9,12,13,12,11,15,18,18,12,7,10,13,7,0,0
0,0,0,0,0,0,0,0,0,0,1,0,0,0,0,0,0,0,0,0,0,0,0,0,0,0,2,3,2,0,0,0,0,2,3,2,0,0,0,0,0,0,0,0,0,0,0,0,0,0,0,0,0,0,0,1,2,1,0,0,0,0,0,0,0,0,0,0,0,0,9,19,20,12,10,9,9,7,8,11,14,16,15,13,8,7,11,14,12,11,13,14,13,11,8,12,16,9,0,0
0,0,0,0,0,0,0,0,0,1,1,0,0,0,0,0,0,0,0,0,0,0,0,0,0,1,0,0,0,0,0,0,0,1,2,1,0,0,0,0,0,0,0,0,0,0,0,0,0,0,0,1,0,0,0,0,1,0,0,0,0,0,1,0,0,0,0,0,0,0,9,20,19,11,10,15,17,16,16,24,24,20,16,12,8,8,10,12,14,17,17,16,13,12,12,18,19,10,0,0
0,0,0,0,0,0,0,0,2,1,0,0,0,0,0,0,0,0,0,0,0,0,0,0,0,0,0,0,1,0,0,0,0,0,1,0,0,0,0,0,0,0,0,0,0,0,0,0,0,0,0,0,0,0,0,0,0,0,0,0,0,0,0,0,0,0,0,0,0,0,9,25,29,19,14,20,24,26,31,37,33,25,17,17,16,17,17,17,19,22,23,20,19,21,24,33,31,13,0,0
0,0,0,0,0,0,0,1,2,2,0,0,0,0,0,0,0,0,0,0,0,0,1,1,0,0,0,0,0,0,0,0,0,0,1,1,0,0,0,0,1,1,1,0,0,0,0,0,0,0,0,0,1,1,0,0,0,0,0,0,0,0,0,0,0,0,0,0,0,0,10,28,37,30,23,23,22,26,34,41,34,26,23,21,23,28,30,29,28,27,22,21,25,29,30,41,38,18,0,0
0,0,0,0,0,0,0,0,1,0,0,0,0,0,0,0,0,0,0,0,0,0,1,1,0,0,0,0,0,0,0,0,0,0,1,2,1,0,0,0,0,1,2,1,0,0,0,0,0,0,0,0,1,1,0,0,0,0,0,0,0,0,1,0,0,0,0,0,0,0,9,28,40,38,31,26,19,18,26,32,30,25,22,19,21,26,32,34,33,24,18,18,23,24,19,34,38,20,0,0
0,0,0,0,0,0,0,0,0,0,0,0,0,0,0,0,0,0,0,0,0,0,0,0,0,0,0,0,0,1,0,0,1,0,1,2,1,0,0,0,0,0,1,0,0,0,0,0,0,0,0,0,0,0,0,0,0,0,0,0,0,0,0,0,0,0,0,0,0,0,11,30,39,38,36,31,20,12,14,21,25,25,21,14,12,17,24,29,29,21,17,18,20,15,11,29,37,21,0,0
0,0,0,0,0,0,0,0,0,0,0,0,0,0,0,0,0,0,0,1,1,0,0,0,0,0,0,0,0,0,0,0,0,0,0,1,0,0,0,0,0,0,0,0,0,0,0,0,0,0,0,0,0,0,0,0,0,0,0,0,0,0,0,0,0,0,0,0,0,0,15,33,38,29,29,25,17,11,11,18,27,33,27,20,14,17,21,25,23,21,21,23,20,16,15,34,39,21,0,0
0,0,0,0,1,1,0,0,0,0,0,0,0,0,0,0,0,1,1,1,0,0,0,0,0,0,0,0,0,0,0,0,0,0,0,0,0,0,0,0,0,0,0,0,0,0,0,0,0,0,0,0,0,0,0,0,0,0,0,0,0,0,1,0,0,0,0,0,0,0,14,27,25,14,17,18,13,9,11,21,31,37,33,27,21,23,23,23,21,24,24,24,19,16,15,28,30,15,0,0
0,0,0,0,1,1,1,0,0,0,0,0,0,0,1,1,1,1,0,0,0,0,0,0,0,0,0,0,0,0,0,0,1,1,0,0,0,0,0,0,0,0,0,0,0,0,0,0,0,0,0,0,0,0,0,0,0,0,0,0,0,1,2,1,0,0,0,0,0,0,11,22,19,9,13,18,27,46,67,81,82,70,52,38,29,25,26,25,24,24,21,20,16,12,10,18,20,11,0,0
0,0,0,0,0,1,1,0,0,1,1,1,0,0,0,0,0,0,0,0,0,0,0,0,0,0,0,0,0,0,0,0,1,1,0,0,0,0,0,0,0,0,0,0,0,0,0,0,0,0,0,0,0,0,0,0,0,0,0,0,0,1,2,1,0,0,0,0,0,0,36,80,85,66,65,64,71,93,112,121,114,101,80,60,40,34,37,44,49,51,55,62,73,79,72,96,102,53,0,0
0,0,0,0,0,0,0,0,0,0,0,0,0,0,0,0,0,0,0,0,0,0,0,0,0,0,0,0,1,0,0,0,0,0,0,0,0,0,0,0,0,0,0,0,0,0,0,0,0,0,0,0,0,0,0,0,0,0,0,0,0,0,1,0,0,0,0,0,0,0,52,103,122,96,92,83,79,85,85,81,79,86,86,77,57,45,46,51,56,63,70,86,102,118,106,146,135,81,0,0
0,0,0,0,0,0,0,0,0,0,0,0,0,0,0,0,0,0,0,0,0,0,0,0,0,0,0,1,2,1,0,0,0,0,0,0,0,0,0,0,0,0,0,0,0,0,0,0,0,0,0,0,0,0,0,0,0,0,0,0,0,0,0,0,0,0,0,0,0,0,28,64,70,58,55,48,40,29,17,10,16,34,58,69,63,49,42,37,33,35,41,50,61,72,66,83,88,44,0,0
0,0,0,0,0,0,0,0,0,0,0,0,0,0,0,0,0,0,0,0,0,0,0,0,0,0,0,1,2,1,0,0,0,0,0,0,0,0,0,0,0,0,0,0,0,0,0,0,0,0,0,0,0,0,0,0,0,0,0,0,0,0,0,0,0,0,0,0,0,0,0,0,0,0,0,0,0,0,0,0,4,14,32,49,51,40,32,22,8,0,0,0,0,0,0,0,0,0,0,0
0,0,0,0,0,0,0,0,0,0,0,0,0,0,0,0,0,0,0,0,0,0,0,0,0,0,0,0,1,0,0,0,0,0,0,0,0,0,0,0,0,0,0,0,0,0,0,0,0,0,0,0,0,0,0,0,0,0,0,0,0,0,0,0,0,0,0,0,0,0,0,0,0,0,0,0,0,0,0,0,5,11,20,31,39,37,35,28,12,0,0,0,0,0,0,0,0,0,0,0
0,0,0,0,0,0,0,0,0,0,0,0,0,0,0,0,0,0,0,0,0,0,0,0,0,0,0,0,0,0,0,0,0,0,0,0,0,0,0,0,0,0,0,0,0,0,0,0,0,0,0,0,0,0,0,0,0,0,0,0,0,0,0,0,0,0,0,0,0,0,0,0,0,0,0,0,0,0,0,0,5,12,16,21,33,35,36,29,14,0,0,0,0,0,0,0,0,0,0,0
0,0,0,0,0,0,0,0,0,0,0,0,0,0,0,0,0,0,0,0,0,0,0,0,0,0,0,0,0,0,0,0,0,0,0,0,0,0,0,0,0,0,0,0,0,0,0,0,0,0,0,0,0,0,0,0,0,0,0,0,0,0,0,0,0,0,0,0,0,0,0,0,0,0,0,0,0,0,0,0,4,10,10,14,27,34,35,28,16,2,1,0,0,0,0,0,0,0,0,0
0,0,0,0,0,0,0,0,0,0,0,0,0,0,0,0,0,0,0,0,0,0,0,0,0,0,0,0,0,0,0,0,0,0,0,0,0,0,0,0,0,0,0,0,0,0,0,0,0,0,0,0,0,0,0,0,0,0,0,0,0,0,0,0,0,0,0,0,0,0,0,0,0,0,0,0,0,0,0,0,2,8,9,11,21,30,30,26,19,7,1,0,0,0,0,0,0,0,0,0
0,0,0,0,0,0,0,0,0,0,0,0,0,0,0,0,0,0,0,0,0,0,0,0,0,0,0,0,0,0,0,0,0,0,0,0,0,1,0,0,0,0,0,0,0,0,0,0,0,0,0,0,0,0,0,0,0,0,0,0,0,0,0,1,2,2,1,0,0,0,0,0,0,0,0,0,0,0,0,0,1,5,8,9,18,27,25,23,21,13,3,1,1,0,0,0,0,0,0,0
0,0,0,0,0,0,0,0,0,0,0,0,0,0,0,0,0,0,0,0,0,0,0,0,0,0,0,0,0,0,0,0,0,0,0,0,1,2,1,0,0,0,0,0,0,0,0,0,0,0,0,0,0,0,0,0,0,0,0,0,0,0,0,3,4,3,1,1,0,0,0,0,0,0,0,0,0,0,0,0,1,5,9,8,16,24,21,17,21,15,5,1,1,0,0,0,0,0,0,0
0,0,0,0,0,0,0,0,0,0,0,0,0,0,0,0,0,0,0,0,0,0,0,0,0,0,0,0,0,0,0,0,0,0,0,0,0,1,1,1,0,0,0,0,0,0,0,0,0,0,0,0,0,0,0,0,0,0,0,0,0,0,0,2,4,4,2,1,0,0,0,0,0,0,0,0,0,0,0,0,1,6,10,9,15,21,20,15,18,14,6,1,1,1,0,0,0,0,0,0
0,0,0,0,0,0,0,0,0,0,0,0,0,0,0,0,0,0,0,0,0,0,0,0,0,0,0,0,0,1,0,0,0,0,0,0,0,0,1,1,1,0,0,0,0,0,0,0,0,0,0,0,0,0,0,0,0,0,0,0,0,0,0,1,2,2,4,4,2,0,0,0,0,0,0,0,0,0,0,0,1,6,9,9,12,19,18,15,16,15,10,3,0,1,0,0,0,0,0,0
0,0,0,0,0,0,0,0,0,0,0,0,0,0,0,0,0,0,0,0,0,0,0,0,0,0,0,0,1,2,1,0,1,1,1,1,0,0,1,1,1,1,0,0,1,3,3,2,0,0,0,0,0,0,0,0,0,0,0,0,0,0,0,0,0,1,7,9,5,0,0,0,0,0,0,0,0,0,0,0,0,4,8,8,10,16,17,14,14,15,11,4,0,0,0,0,0,0,0,0
0,0,0,0,0,0,0,0,0,0,0,0,0,0,0,0,0,0,0,0,0,0,0,0,0,0,0,0,0,1,1,1,1,0,0,0,0,0,0,0,0,0,0,1,1,4,6,4,0,0,0,0,0,1,1,0,0,0,0,0,0,0,0,0,0,1,8,12,7,0,0,0,0,0,0,0,0,0,0,0,0,3,7,8,11,18,18,13,13,14,11,5,0,0,0,1,0,0,0,0
0,0,0,0,0,0,0,0,0,0,0,0,0,0,0,0,0,0,0,1,0,0,0,0,0,0,0,0,0,0,0,0,0,0,0,0,0,0,0,0,0,0,0,1,0,4,7,4,0,0,0,0,0,1,1,1,1,1,1,1,2,2,1,1,2,2,9,12,7,0,0,0,0,0,0,0,0,0,0,0,0,2,7,9,15,20,18,11,12,13,11,6,2,0,0,1,1,0,0,0
0,0,0,0,0,0,0,0,0,0,0,0,0,0,0,0,0,0,1,2,1,0,1,0,0,0,0,0,0,0,0,0,0,0,0,0,0,0,0,0,0,0,0,0,0,3,5,4,0,0,0,0,0,1,1,1,1,1,1,2,3,5,3,2,2,2,9,13,7,0,0,0,0,0,0,0,0,0,0,0,0,2,6,9,15,20,17,11,12,12,12,8,3,0,0,0,1,0,0,0
0,0,0,0,0,0,0,0,0,0,0,0,0,0,0,0,0,0,0,1,0,0,0,0,0,0,0,1,0,0,0,1,0,0,0,0,0,0,0,0,0,0,0,0,0,1,3,3,2,0,0,1,0,0,0,1,1,1,1,1,3,5,4,1,1,2,10,14,8,0,0,0,0,0,0,0,0,2,2,1,0,3,7,10,15,16,15,12,14,12,13,9,4,0,0,0,0,0,0,0
0,0,0,0,0,0,0,0,0,0,0,0,0,0,0,0,0,0,0,0,0,0,0,0,0,0,0,0,0,0,0,0,0,0,0,0,1,1,0,0,0,1,2,2,1,1,3,4,3,1,0,0,0,0,1,2,2,1,1,1,2,3,2,1,0,2,8,11,6,0,0,0,0,1,1,1,1,3,3,2,1,5,9,12,15,15,15,15,17,14,14,10,5,0,0,0,0,0,0,0
0,0,0,0,0,0,0,0,0,0,0,0,0,0,0,0,0,0,0,0,0,0,0,0,0,0,0,1,1,1,0,0,0,1,0,0,1,1,0,0,1,2,3,4,3,2,3,4,4,2,1,1,1,1,1,1,1,1,0,1,3,3,1,1,1,2,7,8,6,2,3,4,4,4,4,3,2,2,2,1,2,5,8,11,15,14,16,16,19,14,14,10,7,2,0,1,1,0,0,0
0,0,0,0,0,0,0,0,0,0,0,0,0,0,0,0,0,0,0,0,0,0,0,0,0,0,1,2,1,0,0,0,0,0,0,0,0,0,0,0,0,2,3,4,3,3,3,4,4,2,3,3,2,1,1,1,1,1,0,2,4,3,1,2,3,3,6,8,7,6,6,6,6,7,7,6,4,2,1,1,2,4,6,10,15,14,14,15,17,14,14,11,10,5,1,2,3,1,0,0
0,0,0,0,0,0,0,0,0,0,0,0,0,0,0,0,0,0,0,0,0,0,0,0,0,0,0,1,0,0,0,0,0,0,0,0,0,0,0,0,0,0,1,3,4,4,3,5,5,3,2,3,2,1,1,1,1,1,0,1,4,3,2,3,3,4,7,8,7,6,5,4,4,6,7,7,6,5,4,4,4,4,6,12,17,13,12,14,16,13,12,11,12,8,2,3,4,2,0,0
0,0,0,0,0,0,0,0,0,0,0,0,0,0,0,0,0,0,0,0,0,0,0,0,0,0,0,0,0,0,0,0,0,0,0,0,0,0,0,0,0,0,1,3,5,7,6,6,3,1,0,1,1,1,1,1,0,0,0,0,1,2,2,3,4,5,7,6,5,5,3,1,1,2,3,4,5,6,6,7,7,5,6,13,18,15,14,14,15,13,9,7,10,7,2,4,6,3,0,0
0,0,0,0,0,0,0,0,1,0,0,0,0,0,0,0,0,0,0,0,0,0,0,0,0,0,0,0,0,0,0,0,0,0,0,0,0,0,0,0,0,0,1,3,6,8,7,4,1,0,0,0,1,1,0,0,0,0,0,0,0,1,2,3,3,5,6,6,5,6,5,4,2,1,1,1,3,4,5,6,9,7,7,10,15,17,20,16,15,14,10,6,7,7,3,6,8,5,0,0
0,0,0,0,0,0,0,1,2,1,0,0,0,0,0,0,0,0,0,0,0,0,0,0,0,0,0,0,0,0,1,1,1,0,0,1,0,0,1,0,0,0,1,3,5,7,4,1,0,0,0,0,0,1,1,1,0,0,0,0,0,1,2,2,3,5,5,6,6,6,6,5,3,3,2,1,2,2,3,5,8,8,9,9,12,18,25,21,15,13,11,6,6,6,3,6,9,6,0,0
0,0,0,0,0,0,0,0,1,0,0,1,0,0,0,0,0,0,0,0,0,0,0,0,0,0,2,1,0,0,0,0,0,0,0,0,0,0,0,0,0,0,1,3,5,5,3,0,0,0,0,0,0,0,0,1,1,0,1,1,1,1,2,1,4,6,7,6,5,4,4,3,2,2,2,1,1,1,3,4,6,8,12,14,15,19,26,21,14,13,12,8,10,13,10,8,8,4,0,0
0,0,0,0,0,0,0,0,0,0,0,0,0,0,0,0,0,0,0,0,0,0,0,0,0,1,2,2,0,0,0,0,0,0,0,0,0,0,0,0,0,0,0,1,3,5,3,1,0,0,0,0,0,0,0,0,0,0,1,2,3,2,2,1,5,8,9,6,3,1,1,1,0,0,0,0,0,1,4,8,8,10,18,21,19,19,21,18,15,14,13,11,17,23,20,18,14,7,0,0
0,0,0,0,0,0,0,0,0,0,0,0,0,0,0,1,0,0,0,0,0,0,0,0,0,0,1,0,0,0,0,0,0,0,0,0,0,0,0,0,0,0,0,1,2,5,5,2,0,0,0,0,0,0,0,0,0,0,1,2,3,3,3,2,4,7,10,9,4,0,0,0,0,0,0,0,0,1,6,9,10,12,19,22,22,18,17,17,21,18,14,14,18,25,24,29,26,14,0,0
0,0,0,0,0,0,0,0,0,0,0,0,0,0,0,0,0,0,0,0,1,0,0,0,0,0,0,0,0,0,0,0,0,0,0,0,0,0,0,1,0,0,0,0,1,9,12,7,0,0,0,0,0,0,0,0,0,0,1,1,1,2,2,2,5,7,12,12,7,0,0,0,0,0,0,0,0,3,6,7,8,10,14,17,18,16,15,17,21,19,14,11,13,17,18,27,26,14,0,0
0,0,0,0,0,0,0,0,0,0,0,0,0,0,0,0,0,0,0,0,0,0,0,0,0,1,0,0,0,0,0,1,0,0,0,0,1,2,1,0,0,0,0,1,1,11,15,10,0,0,0,0,0,0,0,0,0,0,0,0,0,0,0,1,6,10,16,15,7,0,0,0,0,0,0,0,1,5,6,4,5,8,11,11,14,16,17,19,23,21,17,13,11,13,14,17,16,8,0,0
0,0,0,0,0,0,0,0,0,0,0,0,0,0,0,0,0,0,0,0,0,0,0,0,0,0,0,0,0,0,0,0,0,0,0,0,2,3,2,0,0,0,1,2,2,6,10,6,0,0,0,0,0,0,0,0,0,0,0,0,0,0,1,1,4,10,16,13,5,0,0,0,1,0,0,1,4,6,5,5,7,9,10,11,12,15,20,24,25,24,20,15,11,12,10,12,11,6,0,0
0,0,0,0,0,0,0,0,0,0,0,0,0,0,1,0,0,0,0,0,1,0,0,0,0,0,0,0,0,0,0,0,0,0,0,0,1,2,1,0,0,0,2,3,2,4,6,3,0,0,0,0,0,0,0,1,1,1,1,1,2,4,4,3,3,8,15,13,5,0,1,4,4,3,2,3,7,17,31,35,24,14,10,10,11,15,23,30,35,40,42,40,42,38,29,36,39,19,0,0
0,0,0,0,0,0,0,0,0,0,0,0,0,1,2,1,0,1,0,0,0,0,0,0,0,1,0,0,0,0,1,0,0,0,0,0,1,0,0,0,0,0,1,2,2,5,6,3,0,0,0,0,0,0,1,2,2,1,2,2,2,4,5,2,2,5,11,10,5,0,2,5,6,4,3,3,7,23,44,62,58,41,24,17,11,16,29,47,54,50,47,50,57,51,39,46,48,25,0,0
0,0,0,0,0,0,0,0,0,0,0,0,0,0,1,0,0,0,0,0,0,0,0,0,0,0,0,0,0,0,0,0,0,0,0,0,0,0,0,0,0,0,0,0,1,3,3,2,0,0,0,0,0,0,0,1,1,1,1,0,1,2,2,0,0,2,5,6,2,0,1,3,3,2,1,1,2,12,28,50,58,58,40,27,16,18,33,55,53,38,27,29,33,31,22,26,28,13,0,0
0,0,0,0,0,0,0,0,0,0,0,0,0,0,0,0,0,0,0,0,0,0,0,0,0,0,0,0,0,0,0,0,0,0,0,0,0,0,0,0,0,0,0,0,0,0,0,0,0,0,0,0,0,0,0,0,0,0,0,0,0,0,0,0,0,0,0,0,0,0,0,0,0,0,0,0,0,0,0,11,29,40,36,26,16,17,28,39,30,9,0,0,0,0,0,0,0,0,0,0
0,0,0,0,0,0,0,0,0,0,0,0,0,0,0,0,0,0,0,0,0,0,0,0,0,0,0,0,0,0,0,0,0,0,0,0,0,0,0,0,0,0,0,0,0,0,0,0,0,0,0,0,0,0,0,0,0,0,0,0,0,0,0,0,0,0,0,0,0,0,0,0,0,0,0,0,0,0,0,0,2,10,14,13,9,10,15,14,6,0,0,0,0,0,0,0,0,0,0,0
