0,0,0,0,0,0,0,0,0,0,0,0,0,0,0,0,0,0,0,0,0,0,0,0,0,0,0,0,0,0,0,0,0,0,0,0,0,0,0,0,0,0,0,0,0,0,0,0,0,0,0,0,0,0,0,0,0,0,0,0,0,0,0,0,0,0,0,0,0,0,0,0,0,0,0,0,0,0,0,0,0,0,0,0,0,0,0,0,0,0,0,0,0,0,0,0,0,0,0,0
0,0,0,0,0,0,0,0,0,0,0,0,0,0,0,0,0,0,0,0,0,0,0,0,0,0,0,0,0,0,0,0,0,0,0,0,0,0,0,0,0,0,0,0,0,0,0,0,0,0,0,0,0,0,0,0,0,0,0,0,0,0,1,1,0,1,1,1,0,0,0,0,0,1,1,1,0,0,0,0,0,0,0,0,0,0,0,0,0,0,0,0,0,0,0,0,0,0,0,0
0,0,0,0,0,0,0,0,0,0,0,0,0,0,0,0,0,0,0,0,0,0,0,0,0,0,0,0,0,0,0,0,0,0,0,0,0,0,0,0,0,0,0,0,0,0,0,0,0,0,0,0,0,0,0,0,0,0,0,0,1,1,1,1,1,2,3,2,1,0,0,0,1,2,3,1,1,0,0,0,0,0,0,0,0,0,0,0,0,0,0,0,0,0,0,0,0,0,0,0
0,0,0,0,0,0,0,0,0,0,0,0,0,0,0,0,0,0,0,0,0,0,0,0,0,0,0,0,0,0,0,0,0,0,0,0,0,0,0,0,0,0,0,0,0,0,0,0,0,0,0,0,0,0,0,0,0,0,0,0,0,0,1,1,0,1,4,5,2,0,0,0,0,1,1,1,1,1,0,0,0,0,0,0,0,0,0,0,0,0,0,0,0,0,0,0,0,0,0,0
0,0,0,0,0,0,0,0,0,0,0,1,0,0,0,0,0,0,0,0,0,0,0,0,0,0,0,0,0,0,0,0,0,0,0,0,0,0,0,0,0,0,0,0,0,0,0,0,0,0,0,0,0,0,0,0,0,0,0,0,0,0,0,0,0,1,6,7,4,0,0,0,0,0,0,0,0,0,0,0,0,0,0,0,0,0,0,0,0,0,0,0,0,0,0,0,0,0,0,0
0,0,0,0,0,0,0,0,0,0,1,2,1,0,0,0,0,0,0,0,0,0,0,0,0,0,0,0,0,0,0,0,0,0,0,0,0,0,0,0,0,0,0,0,0,0,0,0,0,0,0,0,0,0,0,0,0,0,0,0,0,0,0,0,0,2,8,9,4,0,0,0,0,0,0,0,0,0,0,1,0,0,0,0,0,0,0,0,0,0,0,0,0,0,0,0,0,0,0,0
0,0,0,0,0,0,0,0,0,0,0,1,0,0,1,0,0,0,1,0,0,0,0,0,0,0,0,0,0,0,0,0,0,0,0,0,0,0,0,0,0,0,0,0,0,0,0,0,0,0,0,0,0,0,0,0,0,1,1,0,0,1,0,0,0,2,9,12,6,0,0,0,0,0,0,0,0,0,0,0,0,0,0,0,0,0,0,0,0,0,0,0,0,0,0,0,0,0,0,0
0,0,0,0,0,0,0,1,1,0,0,0,0,0,0,0,0,0,0,0,0,0,0,1,0,0,0,0,0,0,0,0,0,0,0,0,0,0,0,0,0,0,0,0,0,0,0,0,0,0,0,0,0,0,0,1,1,1,0,0,0,0,0,0,0,1,11,15,9,0,0,1,0,0,0,0,0,0,0,0,0,0,0,0,0,0,0,0,0,0,0,0,0,0,0,0,0,0,0,0
0,0,0,0,0,0,0,1,1,0,0,0,0,0,0,0,0,0,0,0,0,0,0,0,0,0,0,0,0,1,0,0,0,0,0,0,0,0,0,0,0,0,0,0,0,0,1,0,0,0,0,0,0,0,1,1,0,0,0,0,0,0,0,0,1,2,10,15,8,0,0,0,0,0,0,0,0,0,0,1,1,1,0,0,0,0,0,0,0,0,0,0,0,0,0,0,0,0,0,0
0,0,0,0,0,0,0,1,1,1,0,0,0,0,0,0,0,0,0,0,0,0,0,0,0,0,0,0,0,0,0,0,0,0,0,0,0,0,0,0,0,0,0,0,0,1,2,1,0,0,0,0,0,0,0,0,0,0,0,0,0,0,1,2,2,2,8,11,6,0,0,0,0,0,0,1,2,2,2,2,2,1,0,0,0,0,0,0,0,0,0,0,0,0,0,0,0,0,0,0
0,0,0,0,0,0,0,0,0,1,0,0,0,0,0,0,0,0,0,0,0,0,0,0,0,0,0,0,0,0,0,0,0,0,0,0,1,0,0,0,1,0,0,0,0,1,1,1,1,1,1,1,0,0,0,0,0,0,0,0,0,0,1,1,2,1,7,9,6,0,0,1,1,1,1,1,4,4,3,3,3,1,1,1,1,0,0,0,0,0,0,0,0,0,0,0,0,0,0,0
0,0,0,0,0,0,0,0,0,0,0,0,0,0,0,0,0,0,0,0,0,0,0,0,0,0,0,0,0,0,0,0,0,0,0,0,1,0,0,1,2,1,0,1,1,1,0,0,1,1,1,1,1,0,0,0,0,0,0,0,0,0,1,1,1,1,7,9,8,10,15,10,5,4,4,3,3,3,2,2,3,3,2,2,1,0,1,1,0,0,0,0,0,0,0,0,0,0,0,0
0,0,0,0,0,0,0,0,0,0,0,0,0,0,0,0,0,0,0,0,0,0,0,0,0,0,0,0,0,0,0,0,0,0,0,0,1,1,0,1,1,1,1,1,1,1,1,0,0,1,0,0,0,0,0,0,1,1,1,2,2,2,2,1,0,2,8,12,13,21,25,17,6,7,6,3,1,1,0,0,2,3,2,1,0,0,1,1,1,0,0,0,0,0,0,0,0,0,0,0
0,0,0,0,0,0,0,0,0,0,0,0,0,0,0,0,0,0,0,0,0,0,0,0,0,0,0,0,0,0,0,0,0,0,0,0,0,1,1,0,0,1,1,1,1,0,0,0,0,0,0,0,0,2,1,1,2,2,2,2,3,3,2,1,1,2,9,15,16,21,22,12,3,4,5,3,1,1,1,1,1,1,2,1,0,0,1,1,0,0,0,0,0,0,0,0,0,0,0,0
0,0,0,0,0,0,0,0,0,0,0,0,1,0,0,0,0,0,0,0,0,0,0,0,0,0,0,0,0,0,1,0,0,0,0,0,0,0,0,0,0,0,0,0,1,0,0,0,0,0,0,0,1,3,2,1,2,2,1,1,2,1,1,0,1,3,11,15,15,12,8,2,1,1,1,2,2,2,2,2,2,1,1,1,0,0,0,0,0,0,1,0,0,0,0,0,0,0,0,0
0,0,0,0,0,0,0,0,0,0,0,0,0,0,0,0,0,0,0,0,0,0,0,0,0,0,1,0,0,0,1,1,0,0,0,1,0,0,0,0,0,0,0,0,1,1,1,1,1,1,1,0,1,2,2,1,1,0,1,1,1,1,1,0,0,6,13,15,15,14,10,6,6,5,3,5,7,7,6,6,5,3,2,1,0,0,0,0,0,0,1,1,0,0,0,0,0,0,0,0
0,0,0,0,0,0,0,0,0,0,0,0,0,0,0,0,0,0,0,0,0,0,0,0,0,0,0,0,0,0,1,1,0,0,0,0,0,0,0,0,0,0,0,0,0,1,1,0,0,0,1,1,1,0,0,0,0,0,1,3,5,4,3,0,0,8,32,48,34,15,11,8,9,8,6,6,9,9,8,7,7,7,6,3,0,0,0,0,0,0,0,1,0,0,0,0,0,0,0,0
0,0,0,0,0,0,0,0,0,0,0,0,0,0,0,0,0,0,0,0,0,0,0,1,0,0,0,0,2,1,1,0,0,0,0,0,0,0,0,0,1,0,0,0,0,0,0,0,0,0,0,0,0,0,0,0,0,1,2,3,5,5,2,0,1,8,44,60,44,10,6,4,5,5,5,4,4,5,5,5,7,11,12,7,2,0,1,1,1,0,0,0,0,0,0,0,0,0,0,0
0,0,0,0,0,0,0,0,0,0,0,0,0,0,0,0,1,0,0,0,0,0,0,0,0,0,0,1,2,2,0,0,0,0,0,0,0,0,0,0,0,0,0,0,0,0,0,0,0,0,0,0,0,0,0,0,0,0,1,2,3,2,1,0,1,8,31,42,23,2,0,0,1,1,1,0,0,0,0,0,4,9,13,10,5,1,1,0,0,0,0,0,0,0,0,0,0,0,0,0
0,0,0,0,0,0,0,0,0,0,0,0,0,0,0,0,1,1,0,0,0,0,0,0,0,0,0,0,1,0,0,0,0,0,0,0,1,0,0,1,1,0,0,0,0,0,0,0,0,0,0,0,0,0,0,0,0,0,0,1,1,1,1,2,3,12,18,12,1,0,0,0,1,1,0,0,0,0,0,0,1,4,7,9,8,4,0,0,0,0,0,0,1,0,0,0,0,0,0,0
0,0,0,0,0,0,0,0,0,0,0,0,0,0,0,0,0,1,0,0,0,1,0,0,0,0,0,0,0,0,0,0,0,0,0,0,0,0,1,2,2,1,0,0,0,0,0,0,0,0,0,0,0,0,0,0,0,0,0,1,1,1,2,3,4,15,22,16,3,0,0,0,1,1,0,0,0,0,0,0,0,1,3,7,9,6,1,0,0,1,1,1,1,0,0,0,0,0,0,0
0,0,0,0,0,0,0,0,0,0,0,0,0,0,0,0,0,0,0,0,0,0,0,0,0,0,0,0,0,0,0,0,0,0,0,0,0,0,0,1,1,1,1,0,0,1,0,0,0,0,0,0,0,0,0,0,1,1,0,1,1,1,1,3,5,13,25,23,8,0,0,0,0,0,0,0,0,0,0,0,0,0,1,5,8,7,3,0,2,2,2,1,0,0,0,0,0,0,0,0
0,0,0,0,0,0,0,0,0,0,0,0,1,1,1,0,0,0,0,0,0,0,0,0,0,0,0,1,1,1,0,1,0,0,0,0,0,0,0,0,0,0,0,0,0,0,0,0,1,0,0,1,0,0,0,1,1,0,0,0,0,0,1,2,3,7,20,22,12,0,0,0,0,0,0,0,0,0,0,0,0,0,2,3,8,9,5,1,2,2,2,1,0,0,0,0,0,0,0,0
0,0,0,0,0,0,0,0,0,0,0,1,2,1,0,0,0,0,0,0,0,0,0,0,0,1,0,1,1,1,0,0,0,0,0,0,1,1,0,0,0,0,0,0,0,0,0,0,0,0,0,0,0,0,1,1,0,0,0,0,0,0,0,1,2,3,13,19,11,0,0,0,0,1,0,0,0,0,0,0,0,0,1,2,6,8,7,2,2,2,1,0,0,1,0,0,0,0,0,0
0,0,0,0,0,0,0,0,0,0,0,0,1,0,0,0,0,0,0,0,0,0,0,0,0,0,0,0,0,0,0,0,0,0,0,0,1,1,0,0,0,0,0,0,0,0,0,0,0,0,0,0,0,0,1,0,0,0,0,0,0,0,0,0,1,0,10,16,10,0,0,0,0,0,0,0,0,0,0,0,0,0,1,1,4,7,7,4,2,1,1,0,0,0,0,0,0,0,0,0
0,0,0,0,0,0,0,0,0,0,0,0,0,0,0,0,0,0,0,0,1,1,1,1,0,0,0,0,0,0,0,0,0,0,0,0,2,2,1,0,0,0,0,0,0,0,0,0,0,0,0,0,1,1,1,1,1,0,0,1,1,1,0,0,0,0,8,13,8,0,0,0,0,0,0,0,0,0,0,0,0,0,0,1,1,5,8,5,1,0,0,0,0,0,0,0,1,0,0,0
0,0,0,0,0,0,0,0,0,0,0,0,0,0,0,0,0,0,0,1,2,2,1,0,0,0,0,0,0,0,0,0,0,0,0,0,1,1,1,1,0,0,1,0,0,1,1,1,0,0,0,1,2,1,0,1,1,0,0,1,1,1,0,0,0,0,3,6,3,0,0,0,0,0,0,0,0,0,0,0,0,0,0,2,2,6,7,4,0,0,0,0,0,1,0,0,0,0,0,0
0,0,0,0,0,0,0,0,0,0,0,0,0,0,0,0,0,0,0,0,1,1,0,0,0,0,0,0,0,0,0,0,0,0,0,0,1,1,0,0,0,0,0,0,0,1,1,1,1,0,0,1,2,1,0,1,1,0,0,0,0,0,0,0,0,0,0,1,0,0,0,0,0,1,0,0,0,0,0,0,0,0,0,2,3,5,7,4,1,1,0,0,0,0,0,0,0,0,0,0
0,0,0,0,0,0,0,0,0,0,0,0,0,0,0,0,0,0,0,0,0,0,0,0,0,0,0,0,0,0,0,0,0,0,0,0,0,0,0,0,0,0,0,0,0,0,0,0,0,0,0,0,0,0,0,0,0,0,0,0,0,0,0,0,0,0,0,0,0,0,0,0,0,0,0,0,0,0,0,0,0,0,0,1,2,4,5,4,4,2,1,0,0,0,0,0,0,0,0,0
0,0,0,0,0,0,0,0,0,0,0,0,0,0,0,0,0,0,0,0,0,0,0,0,0,0,0,0,0,0,0,0,0,0,0,0,0,0,0,0,0,0,0,0,0,0,0,0,0,0,0,0,0,0,0,0,0,0,0,0,0,0,0,0,0,0,0,0,0,0,0,0,0,0,0,0,0,0,0,0,0,0,0,1,3,3,4,5,4,3,2,0,0,0,0,0,0,0,0,0
0,0,0,0,0,0,0,0,0,0,0,0,0,0,0,0,0,0,0,0,0,0,0,0,0,0,0,0,0,0,0,0,0,0,0,0,0,0,0,0,0,0,0,0,0,0,0,0,0,0,0,0,0,0,0,0,0,0,0,0,0,0,0,0,0,0,0,0,0,0,0,0,0,0,0,0,0,0,0,0,0,0,0,2,3,2,3,4,3,2,2,1,0,1,0,0,0,0,0,0
0,0,0,0,0,0,0,0,0,0,0,0,0,0,0,0,0,0,0,0,0,0,0,0,0,0,0,0,0,0,0,0,0,0,0,0,0,0,0,0,0,0,0,0,0,0,0,0,0,0,0,0,0,0,0,0,0,0,0,0,0,0,1,2,3,1,0,0,0,0,0,0,0,0,0,1,0,0,0,0,0,0,0,2,3,2,4,6,4,2,3,1,0,0,0,0,0,0,0,0
0,0,0,0,0,0,0,0,0,0,0,0,0,0,0,0,0,0,0,0,0,0,0,0,0,0,0,0,0,0,0,0,0,0,0,0,0,0,0,0,0,0,0,0,0,0,0,0,0,0,0,0,0,0,0,0,0,0,0,0,0,0,1,4,5,3,0,0,0,0,0,0,0,0,0,0,0,0,0,1,0,0,0,2,2,2,5,6,3,1,2,2,2,0,0,0,1,0,0,0
0,0,0,0,0,0,0,0,0,0,0,1,1,0,0,0,0,0,0,0,0,0,0,0,0,0,0,0,0,0,0,0,0,0,0,1,0,0,0,0,0,1,0,0,0,0,0,0,0,0,0,0,0,0,0,0,0,0,0,0,0,1,2,3,4,3,0,0,0,0,0,0,0,0,0,0,0,0,0,0,0,0,0,2,3,2,4,5,3,1,2,3,3,2,0,0,0,0,0,0
0,0,0,0,0,0,0,0,0,0,1,2,2,1,0,0,0,0,0,0,0,0,0,0,0,0,0,0,0,1,0,0,0,0,0,0,0,0,0,0,0,0,0,0,0,0,0,0,1,0,0,0,0,0,0,0,0,0,0,0,0,1,1,1,1,2,1,0,0,0,0,0,0,0,1,0,0,0,0,0,0,0,1,2,2,1,2,3,2,1,1,2,3,3,1,0,0,0,0,0
0,0,0,0,0,0,1,1,0,0,0,1,1,0,0,0,1,0,0,1,0,0,0,0,1,1,0,0,0,0,0,0,0,0,0,0,0,0,0,0,0,0,0,0,0,0,0,1,1,0,0,0,0,0,0,1,0,0,0,0,0,1,1,0,1,2,1,0,0,0,0,0,0,0,0,0,0,1,0,0,0,0,1,2,2,1,2,3,2,2,2,1,2,2,1,0,0,0,0,0
0,0,0,0,1,1,1,0,0,0,0,0,0,0,0,0,0,0,0,0,0,0,0,0,1,1,0,0,0,0,0,0,0,0,0,0,0,0,0,0,0,0,0,0,0,0,1,2,1,0,0,0,0,0,0,0,0,0,0,0,0,0,0,0,0,1,0,0,0,0,0,0,0,0,0,0,0,0,0,0,0,0,0,0,1,1,3,3,3,2,2,2,1,1,1,0,0,0,0,0
0,0,0,0,1,1,1,0,0,0,0,0,0,0,0,0,0,0,0,0,0,0,0,0,1,1,0,0,0,1,0,0,0,0,0,0,0,0,0,0,0,0,0,0,0,0,1,2,1,0,0,0,0,0,0,0,0,0,0,1,0,0,0,0,0,0,1,1,1,1,0,0,0,0,0,0,0,0,0,0,0,0,0,1,1,1,3,4,4,3,3,2,2,1,1,1,0,0,0,0
0,0,0,0,0,0,0,0,0,0,0,0,0,0,0,0,0,0,0,0,0,1,0,0,0,0,0,0,0,1,1,1,0,0,0,2,1,0,0,0,0,0,0,0,0,0,0,0,0,0,0,0,0,0,1,0,0,0,0,0,0,0,0,0,0,0,1,1,1,0,0,0,0,0,0,0,0,0,0,0,0,0,1,2,1,0,2,5,5,3,2,2,1,1,1,1,1,0,0,0
0,0,0,0,0,0,0,1,1,0,0,0,0,0,0,0,0,0,0,0,0,0,0,0,1,1,1,0,1,1,2,2,1,0,2,2,2,1,1,0,0,1,1,1,0,0,0,0,0,1,1,1,0,1,2,2,1,1,0,0,0,1,2,1,0,0,1,1,0,0,0,0,0,0,0,0,0,0,0,1,1,0,1,2,1,0,0,4,5,3,1,2,1,0,0,1,1,0,0,0
0,0,0,0,0,0,0,0,1,1,0,0,0,0,0,0,0,0,0,0,1,0,0,1,2,2,1,2,3,2,2,2,1,0,1,2,1,1,1,0,1,2,2,1,1,1,1,0,0,2,2,1,0,1,2,2,1,2,2,1,1,1,1,1,0,1,1,1,1,0,0,1,1,1,0,1,0,0,1,1,1,1,1,1,1,1,0,4,6,4,1,2,1,0,0,1,1,0,0,0
0,0,0,0,0,0,0,0,0,0,0,0,1,0,0,0,0,0,0,1,2,2,1,2,2,1,1,2,3,2,1,1,1,0,0,0,1,1,1,0,1,1,1,0,1,1,1,0,0,1,2,2,1,1,1,1,1,3,2,2,1,1,0,0,0,2,2,2,2,2,1,1,2,1,1,1,1,1,1,1,1,2,1,1,2,3,2,5,6,5,2,3,2,0,0,0,1,0,0,0
0,0,0,0,0,0,0,0,0,0,0,0,0,0,0,1,0,0,1,2,2,2,2,1,1,0,0,1,2,1,1,1,1,0,0,0,1,0,0,1,2,2,1,0,0,1,1,0,0,1,2,1,1,2,2,1,1,2,2,1,1,0,0,0,1,2,2,2,3,3,2,0,1,1,2,2,1,1,2,2,3,4,2,2,3,4,3,5,6,5,3,3,2,0,0,0,1,0,0,0
0,0,0,0,0,0,0,0,0,0,0,0,0,0,0,0,0,0,1,2,3,2,1,0,0,0,0,0,1,1,0,1,1,0,0,0,0,0,0,2,3,2,1,1,1,1,0,0,0,0,1,1,1,2,3,1,1,2,2,2,2,1,1,1,2,1,1,2,2,2,1,0,0,1,2,2,1,1,2,2,3,4,3,2,3,4,2,4,5,3,1,1,0,0,0,0,1,0,0,0
0,0,0,0,0,0,0,0,0,0,0,0,0,0,0,0,0,1,1,3,4,2,0,0,0,1,1,1,1,1,1,1,1,1,0,0,0,1,1,1,2,1,0,1,1,1,0,0,1,0,0,1,1,1,2,1,0,2,2,3,4,5,3,2,2,2,1,2,1,1,0,0,0,0,1,1,0,0,1,1,2,3,2,2,3,3,2,4,5,3,0,0,0,0,1,1,1,0,0,0
0,0,0,0,0,0,0,0,0,0,0,0,0,0,0,0,1,2,2,2,3,1,0,1,2,2,2,1,0,1,2,1,1,1,0,0,1,3,3,2,0,0,0,1,2,1,0,0,1,1,2,2,1,1,2,1,1,2,2,2,4,5,4,3,2,3,2,2,1,1,1,0,0,0,0,0,0,0,0,0,2,3,3,3,3,3,3,5,6,3,1,3,2,1,1,2,1,0,0,0
0,0,0,0,0,0,0,0,0,0,0,0,0,0,0,0,1,2,2,1,1,0,1,2,2,2,2,1,0,0,1,0,0,0,0,0,1,3,4,2,1,1,3,2,2,1,1,1,1,1,2,3,1,2,3,2,1,2,2,1,1,3,3,3,3,4,3,2,1,3,4,2,1,1,1,1,2,1,0,0,2,3,3,2,4,5,5,5,6,4,3,4,4,1,1,1,1,0,0,0
0,0,0,0,0,0,0,0,0,0,0,0,0,0,0,0,1,2,2,1,1,3,3,2,1,1,0,0,0,0,0,0,0,0,0,0,0,1,2,1,1,2,3,2,1,1,2,2,1,0,2,2,1,2,4,3,1,2,2,1,0,2,3,3,1,2,1,1,0,2,4,3,2,2,1,2,3,2,1,1,1,2,2,1,2,6,6,7,8,6,3,3,2,1,1,2,2,1,0,0
0,0,0,0,0,0,0,0,0,0,0,0,0,0,0,0,1,2,2,1,4,5,4,1,0,0,0,0,0,0,0,0,0,0,0,0,0,0,0,0,0,1,1,0,0,0,1,1,0,0,0,1,0,0,1,2,1,1,1,1,1,3,4,2,0,0,0,0,0,0,1,2,2,1,1,2,2,0,1,2,2,1,1,0,0,4,6,8,9,6,1,0,0,2,2,3,2,1,0,0
0,0,0,0,0,0,0,0,0,0,0,0,0,0,0,0,0,1,2,2,4,6,4,0,0,0,0,0,0,0,0,0,0,0,0,0,0,0,0,0,0,0,0,0,0,0,0,0,0,0,0,0,0,0,0,0,1,1,0,1,2,5,4,2,0,0,0,0,0,0,0,1,1,1,0,1,1,0,2,3,2,1,1,0,0,2,5,9,9,5,1,2,3,3,3,3,3,2,0,0
0,0,0,0,0,0,0,0,0,0,0,0,0,0,0,0,0,1,2,2,3,4,4,3,1,0,0,0,0,0,0,0,0,0,0,0,0,0,0,0,0,0,0,0,0,0,0,0,0,0,0,0,0,0,0,0,0,0,0,1,2,4,4,2,0,0,0,0,0,0,0,0,1,0,0,0,1,1,2,2,1,1,1,1,1,2,4,8,9,6,2,4,5,4,2,4,5,3,0,0
0,0,0,0,0,0,0,0,0,0,0,0,2,3,2,0,0,0,1,2,3,4,5,5,7,6,3,1,0,0,1,4,4,2,1,1,1,0,0,0,0,0,0,0,0,0,0,0,0,0,0,0,0,0,0,0,0,0,0,1,0,1,2,1,0,0,0,0,0,0,0,0,1,0,0,0,0,0,1,1,1,0,1,2,3,2,3,8,10,7,3,4,5,3,1,4,6,4,0,0
0,0,0,0,0,0,0,0,0,0,0,0,4,6,4,0,0,0,1,2,3,3,3,5,10,11,6,2,3,1,3,6,6,3,2,3,3,1,0,0,0,0,0,0,0,0,0,0,0,0,0,0,1,1,1,1,0,0,0,0,0,0,1,0,0,0,0,0,0,0,0,0,0,0,0,0,0,0,0,1,1,1,3,6,9,8,6,10,14,11,5,4,4,4,2,4,5,3,0,0
0,0,0,0,0,0,0,0,0,0,0,0,3,4,2,0,0,0,0,1,1,1,0,1,6,8,5,3,4,3,2,4,4,2,1,2,2,1,0,0,0,0,0,0,0,0,0,0,0,0,0,1,1,0,0,0,0,0,0,0,0,0,1,0,0,0,0,0,0,0,0,0,0,0,1,2,1,0,0,1,3,6,9,11,12,10,7,13,17,13,6,4,5,5,3,5,6,3,0,0
0,0,0,0,0,0,0,0,0,0,0,0,1,0,0,0,0,0,0,0,0,0,0,0,1,3,2,3,4,3,1,0,0,0,0,0,1,1,0,0,0,0,0,0,0,0,0,0,0,0,0,0,0,0,0,0,0,1,0,0,0,0,0,0,0,0,0,0,0,0,0,0,0,0,2,3,3,1,1,2,7,13,15,13,10,7,6,13,17,13,5,4,4,5,5,7,8,4,0,0
0,0,0,0,0,0,0,0,0,0,0,0,1,0,0,0,0,0,0,0,0,0,0,0,1,2,3,3,2,2,1,1,0,0,0,0,1,2,1,0,0,0,0,0,0,0,0,0,0,0,0,0,0,0,0,0,1,1,0,0,0,0,0,0,0,0,0,0,0,0,0,0,0,0,1,3,3,2,2,6,12,17,17,13,9,6,7,14,18,13,6,4,3,4,5,9,9,5,0,0
0,0,0,0,0,0,0,0,0,0,0,0,0,0,0,0,0,0,0,0,0,0,0,0,0,2,3,3,1,1,1,1,1,0,0,0,1,1,1,0,0,0,0,0,0,0,0,0,0,0,0,0,0,0,0,1,2,1,0,0,0,0,0,0,0,0,0,0,0,0,0,0,2,4,2,1,2,6,13,20,24,25,19,13,13,12,10,15,19,14,8,6,4,4,5,10,12,7,0,0
0,0,0,0,0,0,0,0,0,1,1,0,0,0,0,0,0,0,2,2,1,0,0,0,0,1,2,1,0,0,1,2,2,1,0,0,0,0,0,0,0,0,0,0,0,0,0,0,0,0,0,1,0,0,0,0,1,0,0,0,0,0,1,0,0,0,0,0,0,0,1,4,11,15,14,10,11,16,25,32,36,33,22,12,12,13,12,18,23,19,16,16,14,9,5,14,18,10,0,0
0,0,0,0,0,0,0,0,2,2,1,0,0,0,0,0,0,0,2,3,2,0,0,0,1,2,2,1,0,1,1,1,1,1,0,0,0,0,0,0,0,0,0,0,0,0,0,0,0,0,0,0,0,0,0,0,0,0,0,0,0,0,0,0,0,0,0,0,0,0,5,14,24,25,21,18,19,20,24,28,37,40,28,14,17,21,23,27,34,31,25,31,41,35,21,23,23,11,0,0
0,0,0,0,0,0,0,1,2,2,0,0,0,0,0,0,0,0,1,2,2,1,1,2,2,2,1,1,1,1,0,0,0,1,0,0,0,0,0,0,1,1,1,0,0,0,0,0,0,0,0,0,1,1,0,0,0,0,0,0,0,0,0,0,0,0,0,0,0,0,8,21,26,20,16,14,15,14,14,18,28,31,26,18,24,30,34,38,41,37,31,40,51,47,32,33,32,15,0,0
0,0,0,0,0,0,0,0,1,0,0,0,0,0,0,0,0,0,0,0,1,1,2,2,2,2,1,0,0,0,0,0,1,2,1,0,0,0,0,0,0,1,2,1,0,0,0,0,0,0,0,0,1,1,0,0,0,0,0,0,0,0,0,0,0,0,0,0,0,0,8,20,21,12,6,6,8,12,17,19,23,23,20,21,26,32,38,41,36,26,23,27,33,30,23,36,38,20,0,0
0,0,0,0,0,0,0,0,0,0,0,0,0,0,0,0,0,0,0,0,0,1,1,1,0,1,1,0,0,0,0,0,2,3,2,0,0,0,0,0,0,0,1,0,0,0,0,0,0,0,0,0,0,0,0,0,0,0,0,0,0,0,1,0,0,0,0,0,0,0,7,15,15,10,9,11,13,16,20,24,23,18,16,21,22,23,32,38,28,15,13,13,9,8,9,27,33,19,0,0
0,0,0,0,0,0,0,0,0,0,0,0,0,0,0,0,0,0,0,0,0,0,0,0,0,0,1,0,0,0,0,0,1,2,1,0,0,0,0,0,0,0,0,0,0,0,0,0,0,0,0,0,0,0,0,0,0,0,0,0,0,0,1,0,0,0,0,0,0,0,5,12,13,14,17,15,13,13,16,22,22,17,15,19,18,15,24,31,28,18,13,9,10,9,7,16,21,11,0,0
0,0,0,0,1,1,0,0,0,0,0,0,0,0,0,0,0,0,1,1,0,0,0,0,0,0,0,0,0,0,0,0,0,0,0,0,0,0,0,0,0,0,0,0,0,0,0,0,0,0,0,0,0,0,0,0,0,0,0,0,0,0,1,0,0,0,0,0,0,0,3,7,12,16,19,17,12,7,11,19,22,19,20,21,17,12,19,27,30,23,18,13,12,10,7,12,15,8,0,0
0,0,0,0,1,1,1,0,0,0,0,0,0,0,1,0,0,1,1,0,0,0,0,0,0,0,0,0,0,0,0,0,1,1,0,0,0,0,0,0,0,0,0,0,0,0,0,0,0,0,0,0,0,0,0,0,0,0,0,0,0,1,2,1,0,0,0,0,0,0,2,7,14,16,15,13,19,31,48,57,59,50,37,26,24,20,24,31,30,22,16,14,11,8,8,15,15,7,0,0
0,0,0,0,0,1,1,1,1,0,0,1,0,0,0,0,0,0,0,0,0,0,0,0,0,0,0,0,0,0,0,0,1,1,0,0,0,0,0,0,0,0,0,0,0,0,0,0,0,0,0,0,0,0,0,0,0,0,0,0,0,1,2,1,0,0,0,0,0,0,37,77,74,51,54,60,66,68,81,87,91,80,58,32,32,33,35,45,48,47,52,59,53,41,36,58,61,27,0,0
0,0,0,0,0,0,0,0,0,0,0,0,0,0,0,0,0,0,0,0,0,0,0,0,0,0,0,0,1,0,0,0,0,0,0,0,0,0,0,0,0,0,0,0,0,0,0,0,0,0,0,0,0,0,0,0,0,0,0,0,0,0,1,0,0,0,0,0,0,0,62,107,110,68,78,83,78,66,64,64,70,76,65,45,39,36,36,46,55,61,71,82,77,59,51,78,78,40,0,0
0,0,0,0,0,0,0,0,0,0,0,0,0,0,0,0,0,0,0,0,0,0,0,0,0,0,0,1,2,1,0,0,0,0,0,0,0,0,0,0,0,0,0,0,0,0,0,0,0,0,0,0,0,0,0,0,0,0,0,0,0,0,0,0,0,0,0,0,0,0,35,70,63,40,46,51,43,24,14,13,24,46,58,49,40,31,29,32,34,34,42,49,47,35,28,45,50,22,0,0
0,0,0,0,0,0,0,0,0,0,0,0,0,0,0,0,0,0,0,0,0,0,0,0,0,0,0,1,2,1,0,0,0,0,0,0,0,0,0,0,0,0,0,0,0,0,0,0,0,0,0,0,0,0,0,0,0,0,0,0,0,0,0,0,0,0,0,0,0,0,0,0,0,0,0,0,0,0,0,0,10,26,36,37,34,27,22,18,8,0,0,0,0,0,0,0,0,0,0,0
0,0,0,0,0,0,0,0,0,0,0,0,0,0,0,0,0,0,0,0,0,0,0,0,0,0,0,0,1,0,0,0,0,0,0,0,0,0,0,0,0,0,0,0,0,0,0,0,0,0,0,0,0,0,0,0,0,0,0,0,0,0,0,0,0,0,0,0,0,0,0,0,0,0,0,0,0,0,0,0,6,16,22,26,27,24,23,19,7,0,0,0,0,0,0,0,0,0,0,0
0,0,0,0,0,0,0,0,0,0,0,0,0,0,0,0,0,0,0,0,0,0,0,0,0,0,0,0,0,0,0,0,0,0,0,0,0,0,0,0,0,0,0,0,0,0,0,0,0,0,0,0,0,0,0,0,0,0,0,0,0,0,0,0,0,0,0,0,0,0,0,0,0,0,0,0,0,0,0,0,3,13,21,25,24,24,24,19,7,0,0,0,0,0,0,0,0,0,0,0
0,0,0,0,0,0,0,0,0,0,0,0,0,0,0,0,0,0,0,0,0,0,0,0,0,0,0,0,0,0,0,0,0,0,0,0,0,0,0,0,0,0,0,0,0,0,0,0,0,0,0,0,0,0,0,0,0,0,0,0,0,0,0,0,0,0,0,0,0,0,0,0,0,0,0,0,0,0,0,0,3,11,21,24,23,23,26,20,10,1,0,0,0,0,0,0,0,0,0,0
0,0,0,0,0,0,0,0,0,0,0,0,0,0,0,0,0,0,0,0,0,0,0,0,0,0,0,0,0,0,0,0,0,0,0,0,0,0,0,0,0,0,0,0,0,0,0,0,0,0,0,0,0,0,0,0,0,0,0,0,0,0,0,0,0,0,0,0,0,0,0,0,0,0,0,0,0,0,0,0,2,9,18,20,21,21,22,18,13,5,0,0,0,0,0,0,0,0,0,0
0,0,0,0,0,0,0,0,0,0,0,0,0,0,0,0,0,0,0,0,0,0,0,0,0,0,0,0,0,0,0,0,0,0,0,0,0,1,0,0,0,0,0,0,0,1,2,1,0,0,0,0,0,0,0,0,0,0,0,0,1,0,1,2,2,0,0,0,0,0,0,0,0,0,0,0,0,0,0,0,1,7,14,18,18,19,18,16,12,7,1,0,0,0,0,0,0,0,0,0
0,0,0,0,0,0,0,0,0,0,0,0,0,0,0,0,0,0,0,0,0,0,0,0,0,0,0,0,0,0,0,0,0,0,0,0,1,2,1,0,0,0,0,0,0,3,5,3,0,0,0,0,0,0,0,0,1,1,0,0,0,0,1,3,3,2,1,1,0,0,0,0,0,0,0,0,0,0,0,0,1,5,12,16,16,19,18,14,11,9,4,1,0,0,0,0,0,0,0,0
0,0,0,0,0,0,0,0,0,0,0,0,0,0,0,0,0,0,0,0,0,0,0,0,0,0,0,0,0,0,0,0,0,0,0,0,0,1,1,1,0,0,0,0,0,3,4,3,0,0,0,0,0,0,0,0,1,1,0,0,0,0,0,1,3,2,1,1,0,0,0,0,0,0,0,0,0,0,0,0,0,2,9,16,16,18,20,15,10,10,6,1,0,0,0,0,0,0,0,0
0,0,0,0,0,0,0,0,0,0,0,0,0,0,0,0,0,0,0,0,0,0,0,0,0,0,0,0,0,1,1,0,0,0,0,0,0,0,1,1,0,0,0,0,0,2,4,2,0,0,0,0,1,1,0,0,0,0,0,0,0,0,0,0,1,1,2,2,1,0,0,0,0,0,0,0,0,0,0,0,0,2,8,13,13,15,19,15,9,9,7,3,1,0,0,0,0,0,0,0
0,0,0,0,0,0,0,0,0,0,0,0,0,0,0,0,0,0,0,0,0,0,0,0,0,0,0,0,1,2,2,1,1,1,1,1,0,0,1,0,0,1,1,1,0,5,7,4,0,0,0,1,1,0,0,0,0,0,0,0,0,0,0,0,0,1,4,4,2,0,0,0,0,0,0,0,0,0,1,0,1,3,6,10,11,15,20,16,9,9,9,4,1,0,0,0,0,0,0,0
0,0,0,0,0,0,0,0,0,0,0,0,0,0,0,0,0,0,0,0,0,0,0,0,0,0,0,0,0,1,1,0,0,0,0,0,0,0,0,0,0,2,3,2,1,7,11,7,0,0,0,0,0,0,0,0,0,0,0,0,0,1,0,0,0,1,6,8,4,0,0,0,0,0,0,0,0,0,0,0,1,3,5,8,9,16,20,17,8,9,10,7,2,0,0,0,0,0,0,0
0,0,0,0,0,0,0,0,0,0,0,0,0,0,0,0,0,0,0,1,1,0,0,0,0,0,0,0,0,0,0,0,0,0,0,0,0,0,0,0,0,2,2,1,1,7,9,5,0,0,0,0,0,0,1,2,2,1,1,0,1,2,1,1,1,1,7,9,5,0,0,0,0,0,0,0,0,0,0,0,0,1,4,7,11,17,22,16,6,6,10,8,3,1,0,0,0,0,0,0
0,0,0,0,0,0,0,0,0,0,0,0,0,0,0,0,0,0,1,2,2,1,0,0,0,0,0,0,0,0,0,0,0,0,0,0,0,0,0,0,0,0,0,0,1,6,9,6,1,0,1,1,1,1,2,2,2,2,1,1,1,2,2,2,3,3,8,11,6,0,0,0,0,0,0,0,0,0,1,0,0,2,6,8,10,17,21,15,6,5,9,8,5,2,1,0,0,0,0,0
0,0,0,0,0,0,0,0,0,0,0,0,0,0,0,0,0,0,0,1,1,0,0,0,0,0,0,0,0,0,0,0,0,0,0,0,0,0,0,0,0,0,0,1,3,7,8,7,3,3,3,3,2,2,2,2,2,1,1,1,1,1,1,2,3,4,10,12,7,0,0,0,0,0,0,0,0,0,1,0,0,3,7,8,10,15,21,17,9,5,9,9,5,2,1,0,0,0,0,0
0,0,0,0,0,0,0,0,0,0,0,0,0,0,0,0,0,0,0,0,0,0,0,0,0,1,0,0,0,1,1,0,0,0,0,0,0,0,0,0,0,1,1,2,4,5,6,6,4,3,3,2,1,2,2,1,1,0,0,1,1,0,0,1,2,3,15,21,12,0,0,0,0,1,1,1,1,2,3,4,3,4,6,6,8,12,20,20,12,4,8,9,6,2,2,1,0,0,0,0
0,0,0,0,0,0,0,0,0,0,0,0,0,0,0,0,0,0,0,0,0,0,0,0,0,0,1,1,1,1,1,1,1,0,0,1,1,1,0,0,1,1,0,2,3,3,4,4,4,2,1,1,1,1,1,1,1,0,1,1,2,2,2,2,2,3,20,27,17,2,2,2,2,3,3,3,4,4,5,7,9,7,7,6,7,11,20,21,13,3,5,9,6,2,2,1,0,0,0,0
0,0,0,0,0,0,0,0,0,0,0,0,0,0,0,0,0,0,0,0,0,0,0,0,0,0,1,2,1,1,1,0,0,0,0,1,1,1,0,0,0,0,1,2,2,3,5,6,3,0,0,1,1,1,0,1,0,0,1,2,3,3,2,3,3,5,19,26,16,4,4,4,4,5,5,5,6,5,5,9,12,11,11,9,7,11,20,20,13,5,6,9,8,4,1,1,1,0,0,0
0,0,0,0,0,0,0,0,0,0,0,0,0,0,0,0,0,0,0,0,0,0,0,0,0,0,0,1,0,0,0,0,0,0,0,0,0,0,0,0,0,1,2,3,2,4,6,5,2,0,0,0,0,0,0,0,0,0,0,1,1,1,1,2,4,7,14,16,12,5,4,3,4,5,5,6,6,6,5,8,10,11,12,11,8,13,19,18,12,8,8,11,11,7,4,3,2,1,0,0
0,0,0,0,0,0,0,0,0,0,0,0,0,0,0,0,0,0,0,0,0,0,0,0,0,0,0,0,0,0,0,0,0,0,0,0,0,0,0,0,0,1,2,3,3,5,6,5,2,1,0,0,0,0,0,0,0,0,0,0,0,0,0,1,5,7,9,12,13,7,2,2,4,5,4,6,9,9,7,8,8,8,12,14,12,15,20,19,14,9,8,11,11,9,6,10,11,6,0,0
0,0,0,0,0,0,0,0,1,0,0,0,0,0,0,0,0,0,0,0,0,0,0,0,0,0,0,0,0,0,0,0,0,0,0,0,0,0,0,0,0,0,1,2,6,8,6,3,2,1,0,0,0,0,0,0,0,0,0,0,0,0,0,1,6,7,6,10,13,10,6,7,7,5,3,5,8,8,6,7,8,9,12,14,15,17,20,21,15,8,5,9,10,8,6,16,21,13,0,0
0,0,0,0,0,0,0,1,2,1,0,0,0,0,0,0,0,0,0,0,0,0,0,0,0,0,0,0,1,1,0,0,0,0,0,0,0,0,0,0,0,0,0,1,8,12,8,2,1,1,0,0,0,0,1,0,0,0,0,0,0,0,0,3,7,6,4,8,10,9,9,9,8,5,3,3,4,5,4,5,8,12,13,11,12,17,19,19,16,9,5,7,8,6,3,14,21,13,0,0
0,0,0,0,0,0,0,0,1,1,1,0,0,0,0,0,0,0,0,0,0,0,0,0,0,0,2,1,1,0,0,0,1,0,0,0,0,0,0,0,0,0,0,1,9,15,10,1,0,0,0,0,0,0,0,0,0,0,0,0,0,0,0,3,6,5,6,11,10,6,7,7,5,3,3,1,1,2,4,5,7,13,15,9,9,17,20,20,20,15,11,9,10,8,5,8,11,6,0,0
0,0,0,0,0,0,0,0,0,0,0,0,0,0,0,0,0,0,0,0,0,0,0,0,0,1,2,2,0,0,0,0,0,0,0,1,0,0,0,0,0,1,1,1,7,15,13,3,0,0,0,0,0,0,0,0,0,0,1,1,2,1,1,3,5,5,9,12,10,4,2,2,1,1,2,2,1,2,5,7,8,14,17,14,16,25,28,25,23,22,20,18,15,11,8,11,11,5,0,0
0,0,0,0,0,0,0,0,0,0,0,0,0,0,1,0,0,0,0,0,0,0,0,0,0,0,1,0,0,0,0,0,0,0,0,0,0,0,0,1,0,1,2,1,5,14,15,6,0,0,0,0,0,0,0,0,0,0,1,1,2,2,2,2,6,8,9,10,7,2,1,2,1,2,2,2,1,2,4,6,9,16,21,21,23,31,34,28,23,22,24,26,24,18,12,14,14,7,0,0
0,0,0,0,0,0,0,0,0,0,0,0,0,0,0,0,0,0,0,1,0,0,0,0,0,0,0,0,0,0,0,0,0,0,0,0,0,0,0,1,1,0,1,1,1,10,13,8,0,0,0,0,0,0,0,0,0,0,0,0,1,2,2,2,8,10,10,7,4,0,0,1,2,2,1,1,1,3,5,6,9,15,22,22,26,31,33,26,20,19,23,26,27,21,14,15,15,7,0,0
0,0,0,0,0,0,0,0,0,0,0,0,0,0,0,0,0,0,0,0,0,0,0,0,0,0,1,0,0,0,0,0,0,0,0,0,1,2,1,1,1,0,0,0,0,8,13,8,0,0,0,0,0,0,0,0,0,0,0,0,0,1,1,1,6,10,13,10,5,0,0,1,2,1,0,0,0,4,7,7,7,13,18,17,19,23,27,24,21,21,24,25,23,19,15,14,11,5,0,0
0,0,0,0,0,0,0,0,0,0,0,0,0,0,0,0,0,0,0,0,0,0,0,0,0,0,0,0,0,0,0,0,1,0,0,0,2,3,2,1,1,0,0,0,0,6,10,6,0,0,0,0,0,0,0,0,0,0,0,0,0,1,1,1,3,8,16,15,6,0,0,0,1,1,1,3,5,8,10,8,7,10,12,11,13,18,23,23,24,25,27,23,16,12,11,13,9,4,0,0
0,0,0,0,0,0,0,0,0,0,0,0,0,0,1,0,0,0,1,1,0,0,0,0,1,0,0,0,0,0,0,1,1,0,0,0,1,2,1,0,0,0,0,0,0,5,8,5,0,0,0,0,0,0,0,1,1,0,1,1,1,1,1,2,2,7,22,26,12,0,3,8,10,8,8,17,25,29,30,30,26,21,19,17,17,17,23,28,38,50,60,51,31,20,23,37,35,16,0,0
0,0,0,0,0,0,0,0,0,0,0,0,0,1,2,1,0,1,1,0,0,0,0,0,0,0,0,0,0,0,0,1,0,0,0,0,1,0,0,0,0,0,0,0,0,2,4,2,0,0,0,0,0,0,1,2,2,1,1,1,1,1,1,1,1,4,20,24,14,0,6,12,15,11,11,23,32,38,38,52,61,51,33,27,26,24,41,71,86,76,72,61,38,24,30,51,47,25,0,0
0,0,0,0,0,0,0,0,0,0,0,0,0,0,1,0,0,0,0,0,0,0,0,0,0,0,0,0,0,0,0,0,0,0,0,0,0,0,0,0,0,0,0,0,0,1,2,1,0,0,0,0,0,0,0,1,1,0,1,1,0,0,0,1,1,1,8,13,7,0,3,8,9,6,6,11,18,20,21,43,62,60,37,28,26,30,58,97,96,65,42,36,20,13,18,30,30,13,0,0
0,0,0,0,0,0,0,0,0,0,0,0,0,0,0,0,0,0,0,0,0,0,0,0,0,0,0,0,0,0,0,0,0,0,0,0,0,0,0,0,0,0,0,0,0,0,0,0,0,0,0,0,0,0,0,0,0,0,0,0,0,0,0,0,0,0,0,0,0,0,0,0,0,0,0,0,0,0,0,11,33,39,27,18,19,29,52,72,57,19,0,0,0,0,0,0,0,0,0,0
0,0,0,0,0,0,0,0,0,0,0,0,0,0,0,0,0,0,0,0,0,0,0,0,0,0,0,0,0,0,0,0,0,0,0,0,0,0,0,0,0,0,0,0,0,0,0,0,0,0,0,0,0,0,0,0,0,0,0,0,0,0,0,0,0,0,0,0,0,0,0,0,0,0,0,0,0,0,0,0,6,13,14,10,9,17,25,21,6,0,0,0,0,0,0,0,0,0,0,0
