0,0,0,0,0,0,0,0,0,0,0,0,0,0,0,0,0,0,0,0,0,0,0,0,0,0,0,0,0,0,0,0,0,0,0,0,0,0,0,0,0,0,0,0,0,0,0,0,0,0,0,0,0,0,0,0,0,0,0,0,0,0,0,0,0,0,0,0,0,0,0,0,0,0,0,0,0,0,0,0,0,0,0,0,0,0,0,0,0,0,0,0,0,0,0,0,0,0,0,0
0,0,0,0,0,0,0,0,0,0,0,0,0,0,0,0,0,0,0,0,0,0,0,0,0,0,0,0,0,0,0,0,0,0,0,0,0,0,0,0,0,0,0,0,0,0,0,0,0,0,0,0,0,0,0,0,0,0,0,0,0,0,0,0,0,0,0,0,0,0,0,0,0,0,0,0,0,0,0,0,0,0,0,0,0,0,0,0,0,0,0,0,0,0,0,0,0,0,0,0
0,0,0,0,0,0,0,0,0,0,0,0,0,0,0,0,0,0,0,0,0,0,0,0,0,0,0,0,0,0,0,0,0,0,0,0,0,0,0,0,0,0,0,0,0,0,0,0,0,0,0,0,0,0,0,0,0,0,0,0,0,0,0,0,0,0,0,0,0,0,0,0,0,0,0,0,0,0,0,0,0,0,0,0,0,0,0,0,0,0,0,0,0,0,0,0,0,0,0,0
0,0,0,0,0,0,0,0,0,0,0,0,0,0,0,0,0,0,0,0,0,0,0,0,0,0,0,0,0,0,0,0,0,0,0,0,0,0,0,0,0,0,0,0,0,0,0,0,0,0,0,0,0,0,0,0,0,0,0,0,0,0,0,0,0,0,1,2,1,0,0,0,0,0,0,0,0,0,0,0,0,0,0,0,0,0,0,0,0,0,0,0,0,0,0,0,0,0,0,0
0,0,0,0,0,0,0,0,0,0,0,1,0,0,0,0,0,0,0,0,0,0,0,0,0,0,0,0,0,0,0,0,0,0,0,0,0,0,0,0,0,0,0,0,0,0,0,0,0,0,0,0,0,0,0,0,0,0,0,0,0,0,0,0,0,0,3,5,3,0,0,0,0,0,0,0,0,0,0,0,0,0,0,0,0,0,0,0,0,0,0,0,0,0,0,0,0,0,0,0
0,0,0,0,0,0,0,0,0,0,1,2,1,0,0,0,0,0,0,0,0,0,0,0,0,0,0,0,0,0,0,0,0,0,0,0,0,0,0,0,0,0,0,0,0,0,0,0,0,0,0,0,0,0,0,0,0,0,0,0,0,0,0,0,1,1,3,4,3,0,0,0,0,0,0,0,0,0,0,0,0,0,0,0,0,0,0,0,0,0,0,0,0,0,0,0,0,0,0,0
0,0,0,0,0,0,0,0,0,0,0,1,0,0,1,0,0,0,1,0,0,0,0,0,0,0,0,0,0,0,0,0,0,0,0,0,0,0,0,0,0,0,0,0,0,0,0,0,0,0,0,0,0,0,1,2,2,1,0,1,1,0,0,1,1,1,2,3,2,0,0,0,0,0,0,0,1,1,1,1,1,1,0,0,1,1,0,0,0,0,0,0,0,0,0,0,0,0,0,0
0,0,0,0,0,0,0,1,1,0,0,0,0,0,0,0,0,0,0,0,0,0,0,1,0,0,0,0,0,0,0,0,0,0,0,0,0,0,0,0,0,0,0,0,0,0,0,0,0,0,0,1,0,0,1,2,3,2,1,1,1,1,1,2,2,1,4,4,2,0,0,0,0,0,0,2,2,2,2,2,1,1,0,0,0,1,1,1,0,0,0,0,0,0,0,0,0,0,0,0
0,0,0,0,0,0,0,1,1,0,0,0,0,0,0,0,0,0,0,0,0,0,0,0,0,0,0,0,1,0,0,0,0,0,0,0,0,0,0,0,0,0,0,0,0,0,1,1,1,0,0,0,0,0,0,1,1,1,0,1,1,0,1,2,2,2,5,5,3,0,0,0,0,0,1,2,2,0,1,1,1,0,0,0,0,0,0,1,1,1,0,0,0,0,0,0,0,0,0,0
0,0,0,0,0,0,0,1,1,1,0,0,0,0,0,0,0,0,0,0,0,0,0,0,0,0,0,0,0,0,0,0,0,0,1,0,0,0,0,0,0,0,0,1,0,1,2,2,1,0,0,0,0,0,0,0,0,0,0,0,0,0,1,2,2,3,4,4,1,0,0,0,0,0,1,2,1,0,0,0,1,1,0,0,0,0,0,0,1,1,0,0,0,0,0,0,0,0,0,0
0,0,0,0,0,0,0,0,0,1,0,0,0,0,0,0,0,0,0,0,0,0,0,0,0,0,0,0,0,0,0,0,0,1,1,0,0,0,0,1,2,1,1,1,0,0,1,1,1,0,0,0,0,0,0,0,0,0,0,0,0,1,1,1,2,2,3,2,2,1,1,2,3,2,1,1,0,0,1,1,2,2,1,0,0,0,0,0,0,0,0,0,0,0,0,0,0,0,0,0
0,0,0,0,0,0,0,0,0,0,0,0,0,0,0,0,0,0,0,0,0,0,0,0,0,0,0,0,0,0,0,0,0,1,0,0,0,0,0,2,2,2,1,0,0,0,0,0,1,1,0,0,1,1,1,1,0,0,0,0,1,1,1,1,2,2,3,2,2,2,5,7,7,6,5,3,1,0,0,1,1,2,1,1,0,0,1,0,0,0,1,1,0,0,0,0,0,0,0,0
0,0,0,0,0,0,0,0,0,0,0,0,0,0,0,0,0,0,0,0,0,0,0,0,0,0,0,0,0,0,0,0,0,0,0,0,0,0,0,0,2,2,1,0,0,0,1,0,0,1,0,0,0,1,1,1,1,1,0,0,0,0,0,1,2,4,3,2,2,3,6,8,8,8,9,6,2,1,0,0,0,0,0,1,1,1,1,0,0,0,1,1,0,0,0,0,0,0,0,0
0,0,0,0,0,0,0,0,0,0,0,0,0,0,0,0,0,0,0,0,0,0,0,0,0,0,0,0,0,0,0,0,0,0,0,0,0,0,0,0,1,2,1,0,0,0,0,0,0,0,0,0,0,1,1,1,1,1,0,0,0,0,1,2,3,5,6,3,2,3,5,5,5,6,8,6,3,3,3,2,1,1,1,1,1,1,1,0,0,0,0,0,1,1,1,0,0,0,0,0
0,0,0,0,0,0,0,0,0,0,0,0,1,0,0,0,0,0,0,0,0,0,0,0,0,0,0,0,0,1,0,0,0,0,0,0,0,0,1,0,0,1,0,0,1,0,0,1,0,0,0,0,1,2,2,1,1,1,0,0,0,0,2,2,2,4,6,5,4,4,3,3,3,4,4,2,2,4,6,5,3,3,2,1,0,1,1,0,0,0,0,0,1,2,2,1,0,0,0,0
0,0,0,0,0,0,0,0,0,0,0,0,0,0,0,0,0,0,0,0,0,0,0,0,0,0,1,0,0,0,0,0,0,0,1,0,0,0,0,0,0,0,0,1,1,0,1,2,1,0,1,1,1,2,2,1,0,0,0,0,0,0,1,2,2,4,7,6,3,3,3,4,5,5,3,2,2,4,7,7,6,5,4,2,1,0,1,1,1,1,0,0,0,1,2,1,0,0,0,0
0,0,0,0,0,0,0,0,0,0,0,0,0,0,0,0,0,0,0,0,0,0,0,0,0,0,0,0,0,0,1,1,0,0,0,0,0,0,0,0,0,0,0,1,0,0,0,1,0,0,1,1,1,0,1,1,0,0,1,1,2,2,2,2,1,4,7,8,7,7,6,7,7,5,3,3,2,2,4,6,6,5,5,4,2,1,1,1,1,0,0,0,0,0,1,1,1,0,0,0
0,0,0,0,0,0,0,0,0,0,0,0,0,0,0,0,1,0,0,0,0,0,0,1,0,0,0,0,2,1,1,0,0,0,0,0,0,0,0,1,0,0,0,0,0,0,0,0,0,0,0,0,0,0,0,1,0,0,0,0,2,3,3,3,4,7,8,10,9,8,7,7,6,3,2,2,1,0,1,2,4,6,6,5,2,1,1,1,0,0,0,1,0,0,0,1,1,0,0,0
0,0,0,0,0,0,0,0,0,0,0,0,0,0,0,0,0,0,0,0,0,0,0,0,0,0,0,1,2,2,0,0,0,0,0,1,0,0,0,0,0,0,0,0,0,0,0,0,0,0,0,0,0,0,0,0,0,0,0,0,1,2,1,3,6,8,6,6,6,5,4,4,3,1,0,0,0,0,0,0,1,4,6,5,2,1,1,0,0,0,0,0,0,0,0,1,2,0,0,0
0,0,0,0,0,0,0,0,0,0,0,0,0,0,0,0,0,0,0,0,0,0,0,0,0,0,0,0,1,0,0,0,0,0,0,0,0,0,0,1,1,0,0,0,0,0,0,0,0,0,0,0,0,0,0,0,0,0,0,0,0,0,0,2,8,11,7,2,0,0,0,0,1,1,0,0,0,0,0,0,1,2,4,4,3,1,0,0,1,1,0,0,0,0,1,2,1,0,0,0
0,0,0,0,0,0,0,0,0,0,0,0,0,0,0,0,0,1,0,0,1,0,0,0,0,0,0,0,0,0,0,0,0,0,0,0,0,0,1,2,2,1,0,0,0,0,0,0,0,0,0,0,0,0,0,0,0,0,0,0,0,0,0,0,7,11,10,4,1,0,0,0,1,1,0,0,0,0,0,0,0,1,2,3,4,3,1,1,2,3,1,0,0,1,1,1,1,0,0,0
0,0,0,0,0,0,0,0,0,0,0,0,0,0,0,0,0,0,0,0,0,0,0,0,0,0,1,0,0,0,0,0,0,0,0,0,0,0,0,1,1,1,1,0,0,1,1,0,0,0,0,0,0,0,0,0,1,1,1,0,0,1,1,0,4,8,11,7,3,0,0,0,0,0,0,0,0,0,0,0,0,1,3,4,4,4,2,1,2,3,2,0,0,0,0,1,1,0,0,0
0,0,0,0,0,0,0,0,0,0,0,0,1,1,1,0,0,0,0,0,0,0,0,0,0,0,1,1,0,0,1,0,0,0,0,0,0,0,0,0,0,0,0,0,0,0,1,1,0,0,1,0,0,1,0,0,1,1,1,0,0,0,1,1,1,3,9,10,4,0,0,0,0,0,0,0,0,0,0,0,0,0,3,3,4,3,2,0,1,2,1,0,0,0,0,1,1,1,0,0
0,0,0,0,0,0,0,0,0,0,0,1,2,1,0,0,0,0,0,0,0,0,0,0,0,0,1,1,0,0,0,0,0,1,0,0,0,0,0,0,0,0,0,0,0,0,0,0,0,0,0,0,0,1,1,0,1,1,0,0,0,0,0,0,0,2,8,9,4,0,0,0,0,1,0,0,0,0,0,0,0,0,1,3,3,2,2,1,1,1,0,0,0,1,1,1,1,1,0,0
0,0,0,0,0,0,0,0,0,0,0,0,1,0,0,0,0,0,0,0,0,0,0,0,1,1,1,0,0,0,0,0,0,0,0,0,0,1,0,0,1,0,0,0,0,0,0,0,0,0,0,0,0,0,1,1,1,0,0,0,0,0,0,0,0,1,5,6,3,0,0,0,0,0,0,0,0,0,0,0,0,0,1,2,3,2,2,1,1,1,0,0,1,1,0,0,0,0,0,0
0,0,0,0,0,0,0,0,0,0,0,0,0,0,0,0,0,0,0,0,1,1,1,1,1,0,0,0,0,0,0,0,0,0,0,0,1,1,1,1,1,0,0,0,0,0,0,0,1,0,0,0,1,1,1,1,1,0,0,0,1,0,0,0,0,1,3,4,1,0,0,0,0,0,0,0,0,0,0,0,0,0,1,2,3,4,3,1,1,1,0,0,0,0,0,0,0,0,0,0
0,0,0,0,0,0,0,0,0,0,0,0,0,0,0,0,0,0,0,1,2,2,1,0,0,0,0,0,0,0,0,0,0,0,0,0,1,1,1,1,0,0,1,1,0,0,0,1,1,0,0,1,2,2,0,0,1,0,0,0,0,0,0,1,0,0,4,6,3,0,0,0,0,0,0,0,0,0,0,0,0,0,0,2,4,6,5,2,1,1,1,0,0,0,0,1,1,0,0,0
0,0,0,0,0,0,0,0,0,0,0,0,0,0,0,0,0,0,0,0,1,1,0,0,0,0,0,0,0,0,0,0,0,0,0,0,1,1,0,0,0,0,0,1,1,0,0,1,0,0,1,1,1,1,0,0,0,0,0,0,0,0,0,0,0,0,5,7,5,0,0,0,0,1,0,0,0,0,0,0,0,0,0,1,3,5,4,2,2,2,1,0,0,0,0,2,1,0,0,0
0,0,0,0,0,0,0,0,0,0,0,0,0,0,0,0,0,0,0,0,0,0,0,0,0,0,0,0,0,0,0,0,0,0,0,0,0,0,0,0,0,0,0,0,0,0,0,0,0,0,0,0,0,0,0,0,0,0,0,0,0,0,0,0,0,0,2,4,2,0,0,0,0,0,0,0,0,0,0,0,0,0,0,1,3,3,3,2,1,1,0,0,0,0,1,2,1,0,0,0
0,0,0,0,0,0,0,0,0,0,0,0,0,0,0,0,0,0,0,0,0,0,0,0,0,0,0,0,0,0,0,0,0,0,0,0,0,0,0,0,0,0,0,0,0,0,0,0,0,0,0,0,0,0,0,0,0,0,0,0,0,0,0,0,0,0,0,0,0,0,0,0,0,0,0,0,0,0,0,0,0,0,0,1,2,2,2,1,1,0,0,0,0,0,1,2,1,0,0,0
0,0,0,0,0,0,0,0,0,0,0,0,0,0,0,0,0,0,0,0,0,0,0,0,0,0,0,0,0,0,0,0,0,0,0,0,0,0,0,0,0,0,0,0,0,0,0,0,0,0,0,0,0,0,0,0,0,0,0,0,0,0,0,0,0,0,0,0,0,0,0,0,0,0,0,1,0,0,0,0,0,0,0,1,2,3,3,2,1,1,0,0,0,0,1,1,1,0,0,0
0,0,0,0,0,0,0,0,0,0,0,0,0,0,0,0,0,0,0,0,0,0,0,0,0,0,0,0,0,0,0,0,0,0,0,0,0,0,0,0,0,0,0,0,0,0,0,0,0,0,0,0,0,0,0,0,0,0,0,0,0,0,0,2,3,2,0,0,0,0,0,0,0,0,0,0,0,0,0,0,0,0,0,1,3,4,3,3,2,1,0,0,0,0,0,0,0,0,0,0
0,0,0,0,0,0,0,0,0,0,0,0,0,0,0,0,0,0,0,0,0,0,0,0,0,0,0,0,0,0,0,0,0,0,0,0,0,0,0,0,0,0,0,0,0,0,0,0,0,0,0,0,0,0,0,0,0,0,0,0,0,0,0,4,6,4,0,0,0,0,0,0,0,0,0,0,0,0,0,0,0,0,0,2,3,4,3,3,2,1,0,1,1,0,0,1,1,0,0,0
0,0,0,0,0,0,0,0,0,0,0,1,1,0,0,0,0,0,0,0,0,0,0,0,0,0,0,0,0,0,0,0,0,0,0,0,0,0,0,0,0,0,0,0,0,0,0,0,0,0,0,0,0,0,0,0,0,0,0,0,0,0,0,3,5,4,0,0,0,0,0,0,0,0,0,0,1,1,1,1,0,0,1,2,2,4,4,4,2,2,1,2,2,1,1,2,2,1,0,0
0,0,0,0,0,0,0,0,0,0,1,2,2,1,0,0,0,0,0,0,0,0,0,0,0,0,0,0,0,0,0,0,0,0,0,0,0,0,0,0,0,0,0,0,0,0,0,0,0,0,0,0,0,0,0,0,0,0,0,0,0,0,0,1,2,2,1,0,0,0,0,0,0,0,0,1,1,0,0,0,0,0,1,2,2,3,3,3,2,1,0,1,2,1,1,2,2,1,0,0
0,0,0,0,0,0,1,1,0,0,0,1,1,0,0,0,1,0,0,1,0,0,0,0,0,0,0,0,0,0,1,1,0,0,1,1,0,0,1,1,1,0,0,0,0,0,1,1,0,0,0,0,0,0,0,0,0,0,0,1,1,1,1,1,1,2,2,1,0,0,0,0,0,0,0,0,0,0,0,0,0,0,0,1,1,1,2,3,3,1,0,0,1,1,1,1,1,0,0,0
0,0,0,0,1,1,1,0,0,0,0,0,0,0,0,0,0,0,0,0,0,0,0,1,0,0,0,1,1,1,1,1,0,0,1,1,0,0,1,1,1,0,1,0,0,1,2,3,2,0,0,0,0,0,0,0,0,0,0,0,0,0,0,0,0,1,2,1,1,1,1,1,1,1,0,0,0,0,1,0,0,0,1,1,0,1,1,3,3,2,0,0,1,1,1,0,0,0,0,0
0,0,0,0,1,1,1,0,0,0,0,0,0,0,0,0,0,0,0,0,0,0,0,1,2,1,2,3,3,1,1,1,1,1,1,0,0,1,1,1,0,1,1,0,0,1,3,3,2,0,0,1,1,0,0,1,1,1,0,0,0,0,0,0,0,0,2,2,1,1,1,1,1,1,0,0,0,1,1,0,0,0,1,2,0,1,2,3,3,2,0,1,1,1,1,1,0,0,0,0
0,0,0,0,0,0,0,0,0,0,0,0,0,0,0,0,0,0,0,0,0,0,0,1,2,2,2,2,2,1,0,0,1,1,1,0,1,2,2,1,1,1,1,0,1,1,1,2,2,1,1,2,2,2,2,1,0,1,1,0,0,0,1,0,0,0,1,2,1,1,1,1,1,1,0,0,0,1,0,0,0,1,2,1,0,1,1,3,3,2,1,1,1,1,1,1,1,0,0,0
0,0,0,0,0,0,0,1,1,0,0,0,0,0,0,0,0,0,0,0,0,1,2,2,2,1,0,0,0,0,0,0,1,1,1,1,1,1,2,1,1,1,1,0,1,1,1,0,2,1,1,2,3,5,4,4,2,2,1,1,0,1,1,0,0,0,1,2,2,1,1,1,1,0,0,0,1,1,0,1,1,1,1,2,0,0,1,2,3,3,2,2,1,1,1,1,1,0,0,0
0,0,0,0,0,0,0,0,1,1,1,0,0,0,0,0,0,0,0,0,1,1,2,2,0,0,0,0,1,1,0,1,1,0,0,1,0,0,0,0,0,0,0,0,0,1,0,0,1,1,1,1,3,5,5,4,4,3,1,1,2,2,1,0,0,1,2,2,1,1,1,1,1,0,0,1,1,0,0,1,2,1,1,1,1,2,2,2,3,4,3,2,1,1,1,1,1,0,0,0
0,0,0,0,0,0,0,0,0,0,1,1,0,0,0,0,0,0,0,1,1,1,1,1,0,0,0,1,2,3,2,1,1,0,0,1,1,0,0,0,0,0,0,0,0,1,0,0,0,0,0,0,2,3,3,2,3,2,1,3,4,3,1,1,2,2,2,1,0,0,0,1,0,0,0,1,2,0,0,1,2,2,2,2,3,3,2,1,1,4,4,2,1,2,1,0,0,0,0,0
0,0,0,0,0,0,0,0,0,0,0,0,0,0,1,0,0,1,1,1,2,2,1,1,0,0,1,1,2,2,2,2,1,0,0,1,1,0,0,1,2,2,1,0,0,0,0,0,0,0,0,0,1,2,1,1,1,1,1,2,3,2,1,3,3,2,1,0,0,0,0,0,0,0,0,1,1,1,0,0,2,3,3,2,2,2,1,2,2,3,3,2,1,2,1,0,0,0,0,0
0,0,0,0,0,0,0,0,0,0,0,0,0,0,0,0,0,1,2,2,3,3,2,0,0,0,1,1,1,1,1,1,1,0,0,0,1,0,0,2,3,3,1,1,1,0,0,1,1,0,0,0,1,2,2,1,0,0,0,1,1,1,2,4,3,1,0,2,2,1,1,1,1,1,0,0,1,1,0,1,3,4,3,1,1,0,2,2,3,3,5,3,3,2,1,0,1,0,0,0
0,0,0,0,0,0,0,0,0,0,0,0,0,0,0,0,0,1,2,2,3,3,1,0,0,1,2,2,1,0,0,1,1,0,0,0,1,1,1,1,2,1,1,1,1,0,0,1,2,1,0,0,1,3,3,2,0,0,0,0,1,1,2,3,2,0,1,3,3,2,2,2,2,2,2,0,0,1,1,2,4,4,2,0,0,0,2,3,3,4,5,5,4,4,2,1,2,1,0,0
0,0,0,0,0,0,0,0,0,0,0,0,0,0,0,0,0,1,3,3,2,2,0,0,1,2,3,2,1,0,0,0,1,0,0,0,1,2,2,1,1,0,1,2,1,1,0,2,2,2,1,1,1,3,5,2,0,0,1,2,2,2,2,1,1,0,1,3,3,2,2,2,2,2,2,2,1,2,2,3,3,4,2,1,0,0,2,4,3,3,5,5,4,3,1,1,2,1,0,0
0,0,0,0,0,0,0,0,0,0,0,0,0,0,0,0,0,1,3,2,1,0,0,1,1,2,1,0,0,0,0,0,0,0,0,0,1,2,2,2,2,2,2,2,2,1,1,2,3,1,1,1,2,3,4,4,2,1,2,3,3,3,2,1,0,1,1,2,3,2,1,2,2,1,2,3,3,3,2,3,3,3,2,2,1,1,3,4,3,3,4,4,3,2,1,1,3,1,0,0
0,0,0,0,0,0,0,0,0,0,0,0,0,0,0,0,0,0,1,0,0,1,2,2,1,0,0,0,0,0,0,0,0,0,0,0,0,0,0,1,1,1,1,1,1,1,0,1,2,1,0,1,1,1,2,3,4,2,2,2,2,2,2,1,0,0,0,1,2,1,1,2,2,2,2,3,3,2,1,3,3,3,3,3,1,3,4,5,4,4,3,2,4,3,2,5,8,4,0,0
0,0,0,0,0,0,0,0,0,0,0,0,0,0,0,0,0,1,1,1,3,4,4,3,1,0,0,0,0,0,0,0,0,0,0,0,0,0,0,0,0,0,0,0,0,0,0,0,0,0,0,0,0,0,0,2,3,2,1,0,0,1,1,0,0,0,0,0,0,0,0,1,1,1,1,2,2,1,1,2,3,4,3,3,1,3,5,6,5,5,3,2,3,3,4,10,12,6,0,0
0,0,0,0,0,0,0,0,0,0,0,0,0,0,0,0,0,1,2,3,4,4,3,2,1,0,0,0,0,0,0,0,0,0,0,0,0,0,0,0,0,0,0,0,0,0,0,0,0,0,0,0,0,0,0,0,1,1,0,0,0,0,1,0,0,0,0,0,0,0,0,0,0,0,0,1,1,1,1,2,5,6,5,2,1,2,4,7,7,5,3,4,3,2,5,13,14,6,0,0
0,0,0,0,0,0,0,0,0,0,0,0,0,0,0,0,0,1,1,3,3,3,1,1,0,0,0,0,0,0,0,0,0,0,0,0,0,0,0,0,0,0,0,0,0,0,0,0,0,0,0,0,0,0,0,0,0,0,1,1,0,1,2,1,0,0,0,0,0,0,0,0,0,0,0,0,1,1,0,2,6,6,4,1,1,1,2,5,6,5,4,4,3,3,7,13,12,5,0,0
0,0,0,0,0,0,0,0,0,0,0,0,2,4,3,0,0,0,1,2,2,3,2,2,3,4,3,1,0,1,1,1,1,1,1,1,0,0,0,0,0,0,0,0,0,0,0,0,0,0,0,0,0,1,1,0,0,0,1,2,1,2,2,1,0,0,1,2,1,0,0,0,0,0,0,0,0,0,0,4,6,5,2,2,2,2,2,4,8,9,6,3,4,6,8,11,11,5,0,0
0,0,0,0,0,0,0,0,0,0,0,0,4,7,5,0,0,0,1,1,2,2,2,2,5,7,7,5,3,2,2,3,2,2,2,2,1,0,0,0,0,0,0,0,0,0,0,0,0,0,0,0,1,1,1,0,0,0,0,1,1,1,2,1,1,1,3,4,2,0,0,1,1,2,2,3,3,2,3,6,7,5,5,6,6,6,5,5,10,10,9,7,9,10,8,11,11,6,0,0
0,0,0,0,0,0,0,0,0,0,0,0,3,5,3,0,0,0,1,1,1,1,0,1,3,5,7,7,5,2,1,1,1,1,2,2,1,0,0,0,0,0,0,0,0,0,0,0,0,0,0,1,1,1,1,0,0,0,0,0,0,1,1,1,1,2,4,4,2,0,0,1,2,3,5,7,6,5,5,6,6,5,8,11,11,9,8,6,8,9,10,12,12,10,8,16,21,12,0,0
0,0,0,0,0,0,0,0,0,0,0,0,1,0,0,0,0,0,1,2,2,1,0,0,0,1,3,5,4,1,1,0,0,0,0,1,2,0,0,0,0,0,0,0,0,0,0,0,0,0,0,0,0,0,0,0,0,1,0,0,0,0,1,1,1,2,3,2,0,0,0,1,1,2,5,7,9,8,8,6,4,3,8,14,19,15,10,7,6,7,12,13,11,9,8,24,31,19,0,0
0,0,0,0,0,0,0,0,0,0,0,0,1,0,0,0,0,0,1,1,2,2,1,0,1,2,2,1,1,1,2,2,2,1,1,1,1,1,0,0,0,0,0,0,0,0,0,0,0,0,0,0,0,0,0,0,1,1,0,0,0,0,0,0,0,1,1,0,0,0,0,1,1,1,3,6,7,8,8,7,6,3,3,13,21,20,12,10,10,11,10,9,6,6,8,26,32,18,0,0
0,0,0,0,0,0,0,0,0,0,0,0,0,0,0,0,0,0,0,0,1,1,1,1,1,2,2,1,0,1,2,3,2,2,1,1,0,1,1,0,0,0,0,0,0,0,0,0,0,0,0,0,0,0,0,1,2,1,0,0,0,0,0,0,0,0,0,0,0,0,1,2,1,1,3,5,7,8,8,8,9,8,4,8,17,17,13,11,12,13,9,5,4,7,11,23,25,12,0,0
0,0,0,0,0,0,0,0,0,1,1,0,0,0,0,0,0,0,0,0,0,0,0,0,0,1,1,1,1,1,1,1,2,1,1,0,0,0,0,0,0,0,0,0,0,0,0,0,0,0,0,1,0,0,0,0,1,0,0,0,0,0,1,0,0,0,0,0,0,0,2,4,5,3,5,8,10,11,12,9,9,8,7,8,10,13,12,11,12,12,8,4,6,10,14,21,20,9,0,0
0,0,0,0,0,0,0,0,2,2,1,0,0,0,0,0,0,0,0,0,0,0,0,0,0,0,0,0,0,0,0,0,1,0,0,0,0,0,0,0,0,0,0,0,0,0,0,0,0,0,0,0,0,0,0,0,0,0,0,0,0,0,0,0,0,0,0,0,0,0,3,8,15,16,16,15,17,17,15,12,13,16,16,15,14,14,14,15,16,15,14,12,17,21,21,22,19,8,0,0
0,0,0,0,0,0,0,1,2,2,0,0,0,0,0,0,0,0,0,0,0,0,0,0,1,1,1,0,0,0,0,0,1,1,0,0,0,0,0,0,1,1,1,0,0,0,0,0,0,0,0,0,1,1,0,0,0,0,0,0,0,0,0,0,0,0,0,0,0,0,7,19,28,27,23,19,16,15,18,22,24,26,24,21,17,16,19,23,24,21,18,18,24,28,27,28,25,10,0,0
0,0,0,0,0,0,0,0,1,0,0,0,0,0,0,0,0,0,0,0,0,0,0,0,0,0,0,0,0,0,0,0,1,3,1,0,0,0,0,0,0,1,2,1,0,0,0,0,0,0,0,0,1,1,0,0,0,0,0,0,0,0,0,0,0,0,0,0,0,0,11,24,28,23,18,14,11,12,17,28,33,30,26,24,23,21,20,24,27,23,18,17,22,25,25,36,38,18,0,0
0,0,0,0,0,0,0,0,0,0,0,0,0,0,0,0,0,0,0,0,0,1,1,0,0,0,0,0,0,0,0,0,2,3,2,0,0,0,0,0,0,0,1,0,0,0,0,0,0,0,0,0,0,0,0,0,0,0,0,0,0,0,1,0,0,0,0,0,0,0,10,21,18,7,7,9,9,10,16,26,27,21,22,29,30,24,20,22,26,21,15,13,16,16,17,35,40,21,0,0
0,0,0,0,0,0,0,0,0,0,0,0,0,0,0,0,0,0,0,1,1,1,0,0,0,0,1,0,0,0,0,0,1,2,1,0,0,0,0,0,0,0,0,0,0,0,0,0,0,0,0,0,0,0,0,0,0,0,0,0,0,0,1,0,0,0,0,0,0,0,8,14,10,2,5,9,12,11,14,17,19,16,22,30,34,26,21,24,24,18,13,12,14,13,12,26,34,16,0,0
0,0,0,0,1,1,0,0,0,0,0,0,0,0,0,0,0,1,1,1,0,0,0,0,0,0,0,0,0,0,0,0,0,0,0,0,0,0,0,0,0,0,0,0,0,0,0,0,0,0,0,0,0,0,0,0,0,0,0,0,0,0,1,0,0,0,0,0,0,0,9,15,10,1,4,10,12,11,12,15,17,18,23,28,27,23,24,25,22,16,13,13,12,10,8,19,23,12,0,0
0,0,0,0,1,1,1,0,0,0,0,0,0,0,1,1,1,1,0,0,0,0,0,0,0,0,0,0,0,0,0,0,1,1,0,0,0,0,0,0,0,0,0,0,0,0,0,0,0,0,0,0,0,0,0,0,0,0,0,0,0,1,2,1,0,0,0,0,0,0,8,13,8,2,6,9,12,20,24,29,32,33,34,34,30,25,25,22,17,13,15,13,10,7,4,13,19,11,0,0
0,0,0,0,0,1,1,1,1,0,0,1,0,0,0,0,0,0,0,0,0,0,0,0,0,0,0,0,0,0,0,0,1,1,0,0,0,0,0,0,0,0,0,0,0,0,0,0,0,0,0,0,0,0,0,0,0,0,0,0,0,1,2,1,0,0,0,0,0,0,30,59,51,29,30,31,37,50,55,58,59,54,47,42,39,33,33,33,36,36,44,46,41,39,39,55,59,30,0,0
0,0,0,0,0,0,0,0,0,0,0,0,0,0,0,0,0,0,0,0,0,0,0,0,0,0,0,0,1,0,0,0,0,0,0,0,0,0,0,0,0,0,0,0,0,0,0,0,0,0,0,0,0,0,0,0,0,0,0,0,0,0,1,0,0,0,0,0,0,0,46,79,78,43,43,41,48,56,60,57,59,57,47,40,38,40,43,45,45,46,56,61,60,58,59,81,77,44,0,0
0,0,0,0,0,0,0,0,0,0,0,0,0,0,0,0,0,0,0,0,0,0,0,0,0,0,0,1,2,1,0,0,0,0,0,0,0,0,0,0,0,0,0,0,0,0,0,0,0,0,0,0,0,0,0,0,0,0,0,0,0,0,0,0,0,0,0,0,0,0,25,51,45,26,24,23,26,28,27,24,33,39,34,28,30,35,41,42,33,26,32,37,35,35,36,47,49,23,0,0
0,0,0,0,0,0,0,0,0,0,0,0,0,0,0,0,0,0,0,0,0,0,0,0,0,0,0,1,2,1,0,0,0,0,0,0,0,0,0,0,0,0,0,0,0,0,0,0,0,0,0,0,0,0,0,0,0,0,0,0,0,0,0,0,0,0,0,0,0,0,0,0,0,0,0,0,0,0,0,0,9,19,25,24,25,26,34,30,13,0,0,0,0,0,0,0,0,0,0,0
0,0,0,0,0,0,0,0,0,0,0,0,0,0,0,0,0,0,0,0,0,0,0,0,0,0,0,0,1,0,0,0,0,0,0,0,0,0,0,0,0,0,0,0,0,0,0,0,0,0,0,0,0,0,0,0,0,0,0,0,0,0,0,0,0,0,0,0,0,0,0,0,0,0,0,0,0,0,0,0,6,16,23,26,25,21,27,27,13,0,0,0,0,0,0,0,0,0,0,0
0,0,0,0,0,0,0,0,0,0,0,0,0,0,0,0,0,0,0,0,0,0,0,0,0,0,0,0,0,0,0,0,0,0,0,0,0,0,0,0,0,0,0,0,0,0,0,0,0,0,0,0,0,0,0,0,0,0,0,0,0,0,0,0,0,0,0,0,0,0,0,0,0,0,0,0,0,0,0,0,4,13,21,25,22,19,25,27,14,0,0,0,0,0,0,0,0,0,0,0
0,0,0,0,0,0,0,0,0,0,0,0,0,0,0,0,0,0,0,0,0,0,0,0,0,0,0,0,0,0,0,0,0,0,0,0,0,0,0,0,0,0,0,0,0,0,0,0,0,0,0,0,0,0,0,0,0,0,0,0,0,0,0,0,0,0,0,0,0,0,0,0,0,0,0,0,0,0,0,0,3,9,16,22,20,17,23,25,13,1,0,0,0,0,0,0,0,0,0,0
0,0,0,0,0,0,0,0,0,0,0,0,0,0,0,0,0,0,0,0,0,0,0,0,0,0,0,0,0,0,0,0,0,0,0,0,0,0,0,0,0,0,0,0,0,0,0,0,0,0,0,0,0,0,0,0,0,0,0,0,0,0,0,0,0,0,0,0,0,0,0,0,0,0,0,0,0,0,1,1,3,7,15,22,20,15,19,20,12,3,1,2,1,0,0,0,0,0,0,0
0,0,0,0,0,0,0,0,0,0,0,0,0,0,0,0,0,0,0,0,0,0,0,0,0,0,0,0,0,0,0,0,0,0,0,0,0,1,0,0,0,0,0,0,0,0,0,0,0,0,0,0,0,0,0,0,0,0,0,0,0,0,0,0,2,4,4,4,2,0,0,0,0,0,0,0,0,1,1,0,3,7,15,22,20,16,14,16,13,7,1,2,2,0,0,0,0,0,0,0
0,0,0,0,0,0,0,0,0,0,0,0,0,0,0,0,0,0,0,0,0,0,0,0,0,0,0,0,0,0,0,0,0,0,0,0,1,2,1,0,0,0,0,0,0,0,0,0,0,0,0,0,0,0,0,0,0,0,0,0,0,0,0,2,4,5,8,7,4,0,0,0,0,0,0,0,1,1,1,0,2,5,12,19,19,16,12,14,13,9,1,1,1,0,0,0,0,0,0,0
0,0,0,0,0,0,0,0,0,0,0,0,0,0,0,0,0,0,0,0,0,0,0,0,0,0,0,0,0,0,0,0,0,0,0,0,0,1,2,1,1,0,0,0,0,1,1,0,0,0,0,0,0,0,0,0,0,0,0,0,0,1,1,3,4,4,7,10,5,0,0,0,0,0,0,0,1,2,1,0,2,5,10,18,20,17,12,12,12,9,3,1,1,1,0,0,0,0,0,0
0,0,0,0,0,0,0,0,0,0,0,0,0,0,0,0,0,0,0,0,0,0,0,0,0,0,0,0,0,1,1,0,0,0,0,0,0,0,1,1,1,1,0,0,0,2,2,1,0,0,0,0,0,0,0,0,0,0,0,0,0,1,1,2,1,1,7,11,7,0,0,0,0,0,0,0,1,1,1,0,1,5,9,17,20,16,9,9,11,11,5,1,2,1,0,0,0,0,0,0
0,0,0,0,0,0,0,0,0,0,0,0,0,0,0,0,0,0,0,0,0,0,0,0,0,0,0,0,1,2,2,1,1,1,1,1,0,0,0,0,0,1,1,0,0,2,3,1,0,0,0,0,0,0,0,0,0,0,1,0,0,1,1,0,0,0,9,14,9,0,0,0,0,0,0,0,1,1,0,0,1,3,6,14,19,15,8,7,9,11,7,1,1,2,1,0,0,0,0,0
0,0,0,0,0,0,0,0,0,0,0,0,0,0,0,0,0,0,0,0,0,0,0,0,0,0,0,0,0,1,1,0,0,0,0,0,0,0,0,0,0,0,1,0,0,3,4,3,0,0,0,0,0,0,0,0,0,0,0,0,1,1,1,0,0,1,10,14,9,0,0,0,0,0,0,0,1,0,0,0,1,3,4,11,18,16,9,5,6,10,8,2,1,2,1,0,0,0,0,0
0,0,0,0,0,0,0,0,0,0,0,0,0,0,0,0,0,0,0,1,1,0,0,0,0,0,0,0,0,0,0,0,0,0,0,0,0,0,0,0,0,0,0,0,0,4,6,4,0,0,0,0,0,0,0,0,0,0,0,0,1,3,3,1,1,2,11,15,8,0,0,0,0,0,0,3,3,1,0,0,1,4,6,15,21,20,12,6,4,9,8,3,1,2,1,0,0,0,0,0
0,0,0,0,0,0,0,0,0,0,0,0,0,0,0,0,0,0,1,2,2,1,0,0,0,1,0,0,0,0,0,0,0,0,0,0,0,0,0,0,0,0,0,0,0,4,6,4,1,0,0,0,0,1,1,1,0,0,1,2,4,3,3,2,1,1,10,14,8,0,0,0,0,0,1,4,4,2,0,0,2,5,8,17,23,22,14,8,5,9,8,3,1,2,1,0,0,0,0,0
0,0,0,0,0,0,0,0,0,0,0,0,0,0,0,0,0,0,0,1,1,0,0,0,0,0,0,0,0,0,0,1,0,0,0,0,1,0,0,0,0,0,0,0,0,2,4,3,1,0,0,1,2,1,2,2,1,1,3,4,4,3,3,3,2,1,7,10,6,0,0,0,0,0,1,4,4,2,1,2,4,6,9,17,22,20,15,9,7,9,8,3,1,2,1,0,0,0,0,0
0,0,0,0,0,0,0,0,0,0,0,0,0,0,0,0,0,0,0,0,0,0,0,0,0,0,0,0,0,0,0,1,1,0,0,0,1,0,0,0,0,0,1,1,1,1,1,2,1,0,1,2,2,1,1,1,1,1,3,3,2,1,3,4,4,3,7,9,5,0,0,0,1,1,2,3,2,1,2,3,5,6,9,15,20,19,14,9,6,7,7,3,1,1,2,1,0,0,0,0
0,0,0,0,0,0,0,0,0,0,0,0,0,0,0,0,0,0,0,0,0,0,0,0,0,0,0,1,1,1,0,0,1,0,0,0,1,0,0,1,0,0,0,1,1,1,1,2,3,2,2,2,1,0,0,1,1,1,1,1,1,2,3,4,5,4,8,11,9,4,4,5,5,3,3,4,4,3,3,5,6,6,7,15,20,19,14,9,5,6,7,4,2,1,3,2,0,0,0,0
0,0,0,0,0,0,0,0,0,0,0,0,0,0,0,0,0,0,0,0,0,0,0,0,0,0,1,2,1,0,0,0,0,0,0,0,0,0,0,0,0,0,0,1,1,1,2,4,5,3,4,3,2,0,0,1,1,2,1,1,2,3,4,4,3,3,7,13,13,9,8,8,7,6,5,5,5,5,5,6,7,6,6,14,22,21,15,10,7,7,7,5,3,3,5,4,1,0,0,0
0,0,0,0,0,0,0,0,0,0,0,0,0,0,0,0,0,0,0,0,0,0,0,0,0,0,0,1,0,0,0,0,0,0,0,0,0,0,0,0,0,0,0,0,1,1,3,3,3,2,2,2,2,1,1,1,1,2,1,1,2,4,4,3,1,3,9,12,12,8,7,6,6,7,8,8,6,5,4,5,7,7,8,16,22,21,16,12,10,9,8,5,4,5,8,5,0,0,0,0
0,0,0,0,0,0,0,0,0,0,0,0,0,0,0,0,0,0,0,0,0,0,0,0,0,0,0,0,0,0,0,0,0,0,0,0,0,0,0,0,0,0,0,1,1,3,5,4,1,1,0,1,1,1,1,0,0,1,1,1,1,2,3,4,3,6,11,13,8,4,2,2,2,5,8,10,8,6,4,3,5,7,9,14,21,21,17,13,12,10,8,5,5,6,8,4,0,0,0,0
0,0,0,0,0,0,0,0,1,0,0,0,0,0,0,0,0,0,0,0,0,0,0,0,0,0,0,0,0,0,0,0,0,0,0,1,0,0,1,0,0,0,1,1,4,7,7,4,1,0,0,1,1,1,1,0,0,0,0,1,1,1,3,3,4,7,11,11,6,3,2,2,1,1,5,8,9,8,7,7,6,6,8,14,19,22,17,11,10,9,9,7,5,6,8,4,0,0,0,0
0,0,0,0,0,0,0,1,2,1,0,0,0,0,0,0,0,0,0,0,0,0,0,0,0,0,0,0,1,1,0,0,1,0,0,0,0,0,0,0,0,0,0,1,5,9,7,2,1,0,0,1,1,0,0,0,0,0,0,1,0,1,3,4,5,7,9,8,6,2,2,3,3,3,4,5,5,7,9,8,7,7,9,13,19,23,17,11,10,12,11,11,11,12,12,7,1,0,0,0
0,0,0,0,0,0,0,0,1,1,1,0,0,0,0,0,0,0,0,0,0,0,0,0,0,0,2,1,1,0,0,0,0,0,0,0,0,0,0,0,0,1,1,1,4,6,4,0,0,0,0,0,0,0,0,0,0,0,0,1,0,2,4,4,6,8,10,8,6,3,4,4,4,4,4,2,2,3,6,7,8,10,11,14,18,20,16,12,11,12,12,14,15,18,17,11,3,1,0,0
0,0,0,0,0,0,0,0,0,0,0,0,0,0,0,0,0,0,0,0,0,0,0,0,0,1,2,2,0,0,0,0,0,0,0,0,0,0,0,0,1,2,2,1,1,3,2,0,0,0,0,0,0,0,0,0,0,0,1,1,1,2,4,5,8,10,11,9,6,3,3,2,2,2,1,1,0,1,2,3,6,10,12,15,18,21,18,16,14,12,13,14,14,16,15,11,5,2,0,0
0,0,0,0,0,0,0,0,0,0,0,0,0,0,1,0,0,0,0,0,0,0,0,0,0,0,1,0,0,0,0,0,0,0,0,0,0,0,0,1,1,2,1,0,1,4,5,2,0,0,0,0,0,0,0,0,0,1,1,1,1,1,3,4,8,9,10,8,5,1,1,0,0,0,0,0,0,0,1,2,4,8,12,15,21,22,21,20,16,13,13,11,9,11,14,12,7,3,0,0
0,0,0,0,0,0,0,0,0,0,0,0,0,0,0,0,0,0,0,1,0,0,0,0,0,0,0,0,0,0,0,0,0,0,0,0,0,0,1,2,1,0,0,0,0,4,6,4,0,0,0,0,0,0,0,0,0,0,0,0,1,2,3,4,9,11,10,7,4,0,0,0,0,0,0,0,1,1,2,2,4,10,16,19,20,21,20,18,14,13,14,15,12,13,16,20,18,8,0,0
0,0,0,0,0,0,0,0,0,0,0,0,0,0,0,0,0,0,0,0,0,0,0,0,0,1,0,0,0,0,0,1,0,0,0,0,1,2,2,2,1,0,0,0,0,2,4,2,0,0,0,0,0,0,0,0,0,0,0,0,1,3,4,3,8,11,14,9,4,0,0,0,0,0,0,0,1,1,2,4,8,14,18,18,17,17,16,12,10,13,19,18,14,12,14,25,25,13,0,0
0,0,0,0,0,0,0,0,0,0,0,0,0,0,0,0,0,0,0,0,0,0,0,0,1,1,0,0,0,0,0,0,0,0,0,0,1,2,2,1,1,1,1,0,0,1,1,1,0,0,0,0,0,0,0,0,0,0,0,0,1,4,5,2,4,11,17,14,5,0,0,0,0,0,0,1,1,2,3,7,11,13,15,14,14,15,15,11,9,14,20,22,16,12,11,18,20,11,0,0
0,0,0,0,0,0,0,0,0,0,0,0,0,0,1,0,0,0,1,1,0,0,0,0,1,0,0,0,0,0,0,0,0,0,0,0,1,1,0,0,0,1,1,1,1,3,5,3,0,0,0,0,0,0,0,1,1,0,1,1,3,7,9,6,2,7,22,26,11,0,0,1,4,5,6,11,19,29,35,32,22,13,11,12,14,19,24,23,27,44,62,68,59,43,34,40,35,16,0,0
0,0,0,0,0,0,0,0,0,0,0,0,0,1,2,1,0,1,1,0,0,0,0,0,0,0,0,0,0,0,1,0,0,0,0,0,1,0,0,0,0,0,1,2,1,4,5,3,0,0,0,0,0,0,1,2,2,1,1,2,4,7,10,7,3,2,20,25,15,0,0,2,6,8,9,16,29,44,50,63,68,49,23,17,21,29,38,39,45,60,80,91,80,60,46,54,44,21,0,0
0,0,0,0,0,0,0,0,0,0,0,0,0,0,1,0,0,0,0,0,0,0,0,0,0,0,0,0,0,0,0,0,0,0,0,0,0,0,0,0,0,0,1,1,1,2,3,2,0,0,0,0,0,0,0,1,1,0,1,1,2,3,5,4,2,0,8,13,8,0,0,1,4,5,6,10,17,26,30,59,82,74,36,22,25,35,45,44,38,40,48,54,47,32,26,32,27,11,0,0
0,0,0,0,0,0,0,0,0,0,0,0,0,0,0,0,0,0,0,0,0,0,0,0,0,0,0,0,0,0,0,0,0,0,0,0,0,0,0,0,0,0,0,0,0,0,0,0,0,0,0,0,0,0,0,0,0,0,0,0,0,0,0,0,0,0,0,0,0,0,0,0,0,0,0,0,0,0,0,19,49,51,31,21,20,27,34,30,15,3,0,0,0,0,0,0,0,0,0,0
0,0,0,0,0,0,0,0,0,0,0,0,0,0,0,0,0,0,0,0,0,0,0,0,0,0,0,0,0,0,0,0,0,0,0,0,0,0,0,0,0,0,0,0,0,0,0,0,0,0,0,0,0,0,0,0,0,0,0,0,0,0,0,0,0,0,0,0,0,0,0,0,0,0,0,0,0,0,0,0,4,10,13,11,10,11,16,12,4,0,0,0,0,0,0,0,0,0,0,0
