0,0,0,0,0,0,0,0,0,0,0,0,0,0,0,0,0,0,0,0,0,0,0,0,0,0,0,0,0,0,0,0,0,0,0,0,0,0,0,0,0,0,0,0,0,0,0,0,0,0,0,0,0,0,0,0,0,0,0,0,0,0,0,0,0,0,0,0,0,0,0,0,0,0,0,0,0,0,0,0,0,0,0,0,0,0,0,0,0,0,0,0,0,0,0,0,0,0,0,0
0,0,0,0,0,0,0,0,0,0,0,0,0,0,0,0,0,0,0,0,0,0,0,0,0,0,0,0,0,0,0,0,0,0,0,0,0,0,0,0,0,0,0,0,0,0,0,0,0,0,0,0,0,0,0,0,0,0,0,0,0,0,0,0,0,0,0,0,0,0,0,0,0,1,1,1,0,0,0,0,0,0,0,0,0,0,0,0,0,0,0,0,0,0,0,0,0,0,0,0
0,0,0,0,0,0,0,0,0,0,0,0,0,0,0,0,0,0,0,0,0,0,0,0,0,0,0,0,0,0,0,0,0,0,0,0,0,0,0,0,0,0,0,0,0,0,0,0,0,0,0,0,0,0,0,0,0,0,0,0,0,0,1,0,0,1,2,3,1,0,0,0,0,1,2,1,1,1,1,0,0,0,0,0,0,0,0,0,0,0,0,0,0,0,0,0,0,0,0,0
0,0,0,0,0,0,0,0,0,0,0,0,0,0,0,0,0,0,0,0,0,0,0,0,0,0,0,0,0,0,0,0,0,0,0,0,0,0,0,0,0,0,0,0,0,0,0,0,0,0,0,0,0,0,0,0,0,0,1,0,0,0,0,0,0,0,2,3,2,0,0,0,0,1,1,1,0,1,1,0,0,0,0,0,0,0,0,0,0,0,0,0,0,0,0,0,0,0,0,0
0,0,0,0,0,0,0,0,0,0,0,1,0,0,0,0,0,0,0,0,0,0,0,0,0,0,0,0,0,0,0,0,0,0,0,0,0,0,0,0,0,0,0,0,0,0,0,0,0,0,0,0,0,0,0,0,0,0,0,0,0,0,0,0,0,0,2,3,1,0,0,0,0,1,0,0,0,0,0,0,0,0,0,0,0,0,0,0,0,0,0,0,0,0,0,0,0,0,0,0
0,0,0,0,0,0,0,0,0,0,1,2,1,0,0,0,0,0,0,0,0,0,0,0,0,0,0,0,0,0,0,0,0,0,0,0,0,0,0,0,0,0,0,0,0,0,0,0,0,0,0,0,0,0,0,0,0,0,0,0,0,0,0,0,0,0,2,3,1,0,0,0,0,0,0,0,0,0,0,0,0,0,0,0,0,0,0,0,0,0,0,0,0,0,0,0,0,0,0,0
0,0,0,0,0,0,0,0,0,0,0,1,0,0,0,1,0,0,0,0,0,0,0,0,0,0,0,0,0,0,0,0,0,0,0,0,0,0,0,0,0,0,0,0,0,0,0,0,0,0,0,1,0,0,0,0,0,0,0,0,0,0,0,0,0,0,8,12,7,0,0,0,0,0,0,0,0,0,0,0,1,0,0,0,0,0,0,0,0,0,0,0,0,0,0,0,0,0,0,0
0,0,0,0,0,0,0,1,1,0,0,0,0,0,0,0,0,0,0,0,1,0,0,0,0,0,0,0,0,0,0,0,0,0,0,0,0,0,0,0,0,0,0,0,0,0,0,0,0,0,0,0,0,0,0,0,0,0,0,0,0,0,0,1,1,1,13,19,12,0,0,0,0,0,0,0,0,0,0,0,0,0,0,0,0,0,0,0,0,0,0,0,0,0,0,0,0,0,0,0
0,0,0,0,0,0,0,1,1,0,0,0,0,0,0,0,0,0,0,0,0,0,0,0,0,0,1,0,0,0,0,0,0,0,0,0,0,0,0,0,0,0,0,0,0,1,2,0,0,0,0,0,0,0,0,0,0,0,0,0,0,1,0,1,1,2,14,22,12,0,0,0,0,0,0,0,0,0,0,0,0,0,0,0,1,0,0,0,1,0,0,0,0,0,0,0,0,0,0,0
0,0,0,0,0,0,0,1,1,0,0,0,0,0,0,0,0,0,0,0,0,0,0,0,0,0,0,0,0,0,0,1,0,0,0,0,0,0,1,1,1,0,0,0,0,2,2,1,0,0,0,0,0,0,0,0,0,0,0,0,0,0,0,1,1,3,12,16,9,0,0,1,0,0,0,0,0,0,0,0,1,1,1,1,0,0,0,0,0,0,0,0,1,0,0,0,0,0,0,0
0,0,0,0,0,0,0,0,0,0,0,0,0,0,0,0,0,0,0,0,0,0,0,0,0,0,0,0,0,0,0,0,0,0,0,0,0,0,1,2,2,0,0,0,0,0,1,1,1,1,0,0,0,0,0,0,0,0,1,1,1,0,1,2,2,4,11,12,5,0,0,0,0,0,1,2,1,0,0,0,1,2,2,1,0,0,0,0,0,0,0,0,0,0,0,0,0,0,0,0
0,0,0,0,0,0,0,0,0,1,0,0,0,0,0,0,0,0,0,0,0,0,0,0,0,0,0,0,0,0,0,0,0,0,0,0,0,0,0,2,2,1,0,0,0,0,0,1,1,0,0,0,1,1,1,0,0,0,2,4,2,1,1,2,2,5,10,8,3,4,6,4,1,1,4,5,4,2,0,0,1,1,1,1,1,1,1,1,0,0,0,0,0,0,0,0,0,0,0,0
0,0,0,0,0,0,0,0,0,0,0,0,0,0,0,0,0,0,0,0,0,0,0,0,0,0,0,0,0,0,0,0,0,0,1,0,0,0,0,1,2,1,0,0,0,0,0,0,0,0,0,0,2,2,1,0,0,0,3,4,3,1,1,1,1,6,10,9,5,10,13,9,2,3,5,5,5,2,1,1,1,0,0,0,0,0,0,1,1,0,0,0,0,0,1,0,0,0,0,0
0,0,0,0,0,0,0,0,0,0,0,0,0,1,0,0,0,0,0,0,0,0,0,0,0,0,0,0,0,0,0,0,0,0,0,0,0,0,0,0,1,1,1,1,1,1,0,0,0,0,0,0,2,3,1,0,0,0,1,2,2,0,0,0,1,5,10,11,9,13,15,9,4,3,4,4,3,2,1,1,1,0,0,0,0,0,0,1,1,1,0,0,0,0,0,0,0,0,0,0
0,0,0,0,0,0,0,0,0,0,0,0,0,0,0,0,0,0,0,0,0,0,0,0,0,0,0,0,0,1,0,0,0,0,0,0,1,0,0,0,0,0,0,0,1,2,1,0,0,0,0,0,3,3,2,0,0,0,0,0,0,0,0,0,0,4,12,14,12,12,10,6,3,2,1,1,1,1,1,1,3,3,3,2,1,0,0,1,1,1,0,0,0,0,0,0,0,0,0,0
0,0,0,0,0,0,0,0,0,0,0,0,0,0,0,0,0,0,1,0,0,0,0,1,1,0,0,0,0,1,1,0,0,1,0,0,1,1,0,0,0,0,0,0,1,1,1,0,1,0,0,0,1,2,1,1,1,1,1,1,0,0,0,1,1,5,11,14,13,14,12,7,5,4,4,4,4,3,3,3,4,7,8,4,1,0,0,0,0,1,1,1,1,0,0,1,0,0,0,0
0,0,0,0,0,0,0,0,0,0,0,0,0,0,0,0,0,0,0,0,0,0,0,1,1,0,0,0,0,1,1,0,0,0,0,0,0,1,0,0,0,0,0,0,0,0,0,0,0,0,0,0,0,0,0,0,1,1,2,2,1,1,2,3,2,6,21,31,23,15,12,9,6,6,6,7,6,4,4,4,4,8,11,7,1,0,0,0,0,0,1,1,0,0,0,1,0,0,0,0
0,0,0,0,0,0,0,0,0,0,0,0,0,0,0,0,0,0,0,0,0,0,0,1,1,0,0,0,2,2,1,0,0,0,0,0,0,0,0,0,0,0,0,0,0,0,0,0,0,0,0,0,0,0,0,0,0,0,1,2,2,1,3,3,3,8,30,37,27,10,7,5,4,4,5,6,5,3,2,2,2,6,10,8,3,0,0,0,0,0,1,1,0,0,0,1,0,0,0,0
0,0,0,0,0,0,0,0,0,0,0,0,0,0,0,0,0,0,0,0,0,0,0,0,0,0,0,1,2,2,0,0,0,0,0,0,0,0,0,0,0,0,0,0,0,0,0,0,0,0,0,0,0,0,0,0,0,0,2,3,2,1,1,2,3,12,26,29,14,2,1,1,1,1,1,1,1,0,0,0,1,3,7,9,7,2,0,1,0,0,0,1,0,0,0,0,0,0,0,0
0,0,0,0,0,0,0,0,0,0,0,0,0,0,0,0,0,0,0,1,0,0,0,0,0,0,0,0,1,0,0,0,0,0,0,0,0,0,0,1,1,0,0,0,0,0,0,0,0,0,0,0,0,0,0,0,0,0,2,3,2,1,0,1,4,16,23,13,1,0,0,1,1,1,0,0,0,0,0,0,1,2,4,8,8,4,0,0,0,0,0,1,0,0,0,0,0,0,0,0
0,0,0,0,0,0,0,0,0,0,0,0,0,0,0,0,0,0,0,0,0,0,0,0,0,0,0,0,0,0,0,0,0,0,0,0,0,0,1,2,2,1,1,1,0,0,0,0,1,1,0,0,1,1,1,1,0,0,1,2,2,1,1,1,4,17,24,15,1,0,0,1,2,1,0,0,0,1,0,0,0,1,1,6,8,5,0,0,0,1,1,1,1,0,0,1,1,1,0,0
0,0,0,0,0,0,0,0,0,0,0,0,0,0,0,1,0,0,0,0,0,0,0,0,0,0,0,0,0,0,0,0,1,0,0,0,1,0,1,2,1,0,1,2,1,0,1,1,1,1,0,0,1,1,0,0,0,0,0,0,0,0,1,1,3,11,18,13,2,0,0,0,1,1,0,0,0,0,0,0,0,0,1,5,7,5,1,0,1,2,2,1,1,0,0,1,1,1,0,0
0,0,0,0,0,0,0,0,0,0,0,0,1,0,0,0,0,0,0,0,0,0,0,0,0,0,0,0,0,1,0,0,0,0,0,0,0,0,0,0,0,0,0,1,0,0,0,0,1,1,0,0,0,0,0,0,0,0,0,0,0,0,1,2,2,3,8,8,4,0,0,0,0,1,1,0,0,0,0,0,0,0,1,5,7,5,1,0,1,2,1,0,0,0,0,1,1,0,0,0
0,0,0,0,0,0,0,0,0,0,0,1,2,1,0,0,0,0,0,0,0,0,0,0,0,1,1,0,0,0,0,0,0,0,0,0,0,0,0,0,0,0,0,0,0,0,0,0,0,0,0,0,0,0,0,0,0,0,0,0,0,0,1,2,1,0,6,11,6,0,0,0,0,0,1,0,0,0,1,0,0,0,0,2,5,5,3,0,1,1,0,0,0,0,1,1,1,0,0,0
0,0,0,0,0,0,0,0,0,0,0,0,1,0,0,0,0,0,0,0,0,0,0,0,1,1,0,0,0,0,0,0,0,0,0,0,0,1,0,0,0,0,0,0,0,0,0,0,0,0,0,0,0,0,0,1,0,0,0,0,0,0,0,1,0,0,9,14,9,0,0,0,0,1,1,0,0,1,1,0,0,0,0,0,4,5,3,1,1,0,1,1,0,0,0,0,0,0,0,0
0,0,0,0,0,0,0,0,0,0,0,0,0,0,0,0,0,0,0,0,2,1,0,0,0,0,0,0,0,0,0,0,0,0,0,0,1,1,1,0,0,0,0,0,0,0,0,0,0,0,0,0,1,0,0,1,1,0,0,1,0,0,0,0,0,0,9,15,9,0,0,0,0,1,0,0,0,1,1,0,0,0,0,1,5,8,6,2,1,0,1,2,1,0,0,0,0,0,0,0
0,0,0,0,0,0,0,0,0,0,0,0,0,0,0,0,0,0,0,1,2,2,0,0,0,0,0,0,0,0,0,0,0,0,0,0,1,1,1,1,1,0,0,0,0,0,0,0,0,0,0,1,2,1,0,0,1,0,0,0,0,0,0,0,0,0,6,10,6,0,0,0,0,0,0,0,0,1,1,0,0,0,0,1,5,8,7,3,1,1,1,1,0,0,1,1,1,0,0,0
0,0,0,0,0,0,0,0,0,0,0,0,0,0,0,0,0,0,0,0,1,0,0,0,0,0,0,0,0,0,0,0,0,0,0,0,0,0,0,0,0,0,0,1,0,0,1,0,0,1,0,1,2,1,0,0,0,0,0,0,0,0,0,0,0,0,4,6,4,0,0,0,0,0,0,0,0,0,0,0,0,0,0,0,3,7,7,4,1,1,0,0,0,0,0,1,2,1,0,0
0,0,0,0,0,0,0,0,0,0,0,0,0,0,0,0,0,0,0,0,0,0,0,0,0,0,0,0,0,0,0,0,0,0,0,0,0,0,0,0,0,0,0,0,0,0,0,0,0,0,0,0,0,0,0,0,0,0,0,0,0,0,0,0,0,0,1,2,1,0,0,0,0,0,1,0,0,0,0,1,1,0,0,0,1,5,6,3,1,1,0,0,0,0,0,1,2,1,0,0
0,0,0,0,0,0,0,0,0,0,0,0,0,0,0,0,0,0,0,0,0,0,0,0,0,0,0,0,0,0,0,0,0,0,0,0,0,0,0,0,0,0,0,0,0,0,0,0,0,0,0,0,0,0,0,0,0,0,0,0,0,0,0,0,0,0,0,0,0,0,0,0,0,0,0,0,0,0,0,1,1,1,0,0,1,4,5,3,1,1,1,1,1,0,0,1,2,1,0,0
0,0,0,0,0,0,0,0,0,0,0,0,0,0,0,0,0,0,0,0,0,0,0,0,0,0,0,0,0,0,0,0,0,0,0,0,0,0,0,0,0,0,0,0,0,0,0,0,0,0,0,0,0,0,0,0,0,0,0,0,0,0,0,0,0,0,0,0,0,0,0,0,0,0,0,0,0,0,0,1,1,1,1,1,1,3,4,3,0,1,1,1,1,0,0,0,0,0,0,0
0,0,0,0,0,0,0,0,0,0,0,0,0,0,0,0,0,0,1,0,0,1,0,0,0,1,0,0,0,0,1,0,0,0,0,0,0,0,0,0,0,0,0,0,0,0,0,0,0,0,0,0,0,0,0,0,0,0,0,0,0,0,0,0,0,0,0,0,0,0,0,0,0,0,0,0,0,0,1,1,0,0,0,1,2,5,6,3,1,1,1,1,1,0,0,0,1,0,0,0
0,0,0,0,0,0,0,0,0,0,0,0,0,0,0,0,0,0,0,0,0,0,0,0,0,0,0,0,0,0,0,0,0,0,0,1,1,1,0,0,0,1,1,0,0,0,0,0,0,0,0,0,0,0,0,0,0,0,0,0,0,0,0,0,0,0,0,0,0,0,0,0,0,0,0,0,1,1,1,1,0,0,0,2,2,5,6,4,1,2,2,2,2,0,0,1,2,1,0,0
0,0,0,0,0,0,0,0,0,0,0,1,0,0,0,1,1,0,0,0,0,0,0,0,0,0,0,0,0,0,0,0,1,0,0,1,1,1,0,0,0,1,1,0,0,0,0,0,0,0,0,0,0,0,0,0,0,0,0,0,0,0,0,1,1,0,0,0,0,0,0,0,0,0,0,1,1,0,1,1,0,0,0,1,2,4,6,3,1,1,2,3,3,1,0,1,2,1,0,0
0,0,0,0,0,0,0,0,0,0,1,2,1,0,1,1,1,1,0,0,0,0,0,0,0,0,0,0,1,0,0,0,0,0,0,0,0,0,0,0,0,1,1,0,0,0,0,1,1,1,0,0,0,0,0,0,0,0,0,1,1,0,0,0,1,1,1,0,0,0,0,0,0,0,0,1,0,0,0,0,0,0,0,1,0,3,5,3,0,1,1,2,2,1,0,1,2,1,0,0
0,0,0,0,0,0,1,1,0,0,0,1,0,0,1,1,1,1,0,0,0,0,0,0,0,1,0,0,0,0,0,0,0,0,0,0,0,0,0,0,0,0,0,0,0,0,1,2,1,0,0,0,0,0,0,0,0,0,1,1,0,0,0,0,1,1,1,0,0,0,0,0,0,0,0,0,0,0,1,0,0,0,0,1,0,3,5,3,0,1,2,2,1,0,0,2,3,1,0,0
0,0,0,0,0,1,1,0,0,0,0,0,0,0,0,1,1,0,0,0,0,1,0,0,0,1,0,0,0,0,0,0,0,0,0,0,0,0,0,0,0,0,0,0,0,0,1,2,1,0,0,0,1,0,0,0,0,0,1,1,0,0,0,0,0,0,0,0,1,1,1,1,0,0,0,0,0,0,0,0,0,0,0,0,0,2,4,2,0,1,3,3,2,1,1,3,4,2,0,0
0,0,0,0,0,1,1,0,0,0,0,0,0,0,0,0,0,0,0,0,0,0,0,0,1,1,0,0,0,1,1,0,0,0,0,0,0,0,0,0,0,0,0,0,0,0,1,2,1,0,0,0,0,0,0,0,1,0,0,1,0,0,1,0,0,0,0,0,1,1,2,2,1,0,0,0,1,1,1,0,0,0,1,1,1,4,6,4,1,1,2,3,2,1,1,4,5,3,0,0
0,0,0,0,0,0,1,1,0,0,0,0,0,0,0,0,0,0,0,0,0,0,0,1,1,1,0,0,0,1,1,0,0,0,1,1,1,1,0,0,0,0,1,0,0,0,1,1,0,0,1,0,0,0,1,1,1,1,0,0,0,0,0,0,0,0,0,0,0,1,2,2,1,1,0,0,1,2,1,0,0,0,1,2,2,6,7,5,1,1,2,2,2,1,0,3,5,3,0,0
0,0,0,0,0,0,1,1,0,0,0,0,0,0,0,0,0,0,0,0,0,0,0,0,1,1,0,0,0,1,1,0,0,0,1,2,2,1,0,0,0,1,1,0,0,0,1,1,0,1,1,0,0,1,2,2,1,1,0,0,0,0,0,0,0,1,1,0,0,0,0,0,0,1,0,0,1,1,1,0,0,0,1,1,2,5,6,4,1,1,1,2,1,1,1,2,3,1,0,0
0,0,0,0,0,0,0,0,0,0,1,1,0,0,0,0,0,1,0,0,1,1,1,0,0,0,0,1,2,1,0,1,0,0,0,0,1,1,0,0,1,1,1,1,0,0,0,0,0,1,1,0,0,1,2,2,2,2,2,2,1,0,0,0,1,2,1,1,1,1,0,0,0,1,0,0,1,1,0,0,0,0,0,0,0,3,5,3,0,0,1,1,1,2,2,3,2,1,0,0
0,0,0,0,0,0,0,0,0,0,0,1,1,0,0,0,1,1,0,0,1,1,1,0,0,0,0,2,3,2,2,2,1,0,0,0,0,0,1,1,0,0,0,1,1,0,0,0,0,2,2,2,1,2,2,2,3,2,2,2,2,0,1,2,2,1,1,0,1,1,0,0,0,0,0,2,3,2,0,0,0,1,2,1,0,3,5,4,0,1,1,1,2,2,4,6,5,2,0,0
0,0,0,0,0,0,0,0,0,0,0,0,0,0,0,0,1,0,0,1,1,1,1,0,0,1,0,1,3,3,2,2,0,0,1,0,0,1,2,2,1,1,1,0,1,1,0,0,0,1,2,1,2,1,2,3,3,2,1,1,1,1,2,3,2,1,0,0,0,1,1,0,0,0,1,2,2,1,1,1,2,3,2,1,0,3,5,4,1,1,2,3,3,3,4,7,7,3,0,0
0,0,0,0,0,0,0,0,0,0,0,0,0,0,0,0,1,1,1,2,1,1,1,1,1,1,0,1,2,2,1,0,0,0,1,0,0,0,1,2,2,3,1,0,0,1,2,0,0,1,1,1,1,1,2,3,2,0,0,0,1,2,3,3,2,2,1,1,0,2,3,2,0,0,1,2,1,1,1,2,2,3,2,1,0,2,4,5,2,1,3,3,2,2,3,7,7,4,0,0
0,0,0,0,0,0,0,0,0,0,0,0,0,0,0,0,0,1,1,2,1,0,0,1,1,1,1,1,2,2,1,0,0,0,1,1,0,0,0,1,1,2,1,0,0,2,2,1,1,2,2,2,2,1,2,3,2,1,1,2,2,2,1,1,2,2,1,1,2,3,3,2,1,1,2,2,1,1,2,3,2,1,1,1,1,1,4,5,3,2,2,3,3,2,2,5,6,4,0,0
0,0,0,0,0,0,0,0,0,0,0,0,0,0,0,0,0,0,1,2,1,0,0,0,1,1,1,1,0,0,0,0,0,0,0,1,1,2,2,1,0,0,1,1,0,1,2,1,2,2,2,2,2,1,2,2,2,2,2,2,2,1,2,2,2,2,0,2,4,4,2,1,1,1,2,2,2,1,1,2,2,1,1,1,1,2,5,6,5,2,2,2,3,3,1,4,6,4,0,0
0,0,0,0,0,0,0,0,0,0,0,0,0,0,0,0,0,0,0,1,1,0,0,1,1,1,0,0,0,0,0,0,0,0,0,0,1,2,3,2,0,1,2,1,1,2,1,1,1,1,2,2,2,2,1,2,3,2,1,1,1,1,2,2,2,2,0,1,3,3,2,1,1,2,2,2,2,2,2,3,4,3,1,1,2,4,7,8,5,2,2,2,4,5,2,3,5,3,0,0
0,0,0,0,0,0,0,0,0,0,0,0,0,0,0,0,1,0,0,1,1,2,3,2,1,0,0,0,0,0,0,0,0,0,0,0,0,1,1,1,0,1,2,1,1,1,1,0,0,0,2,2,2,1,1,1,2,1,0,1,1,1,1,1,1,1,0,0,1,1,1,2,3,3,2,2,2,3,3,5,4,3,2,3,4,6,11,11,7,3,3,2,4,5,4,5,6,3,0,0
0,0,0,0,0,0,0,0,0,0,0,0,0,0,0,0,1,1,1,1,2,3,5,4,1,0,0,0,0,0,0,0,0,0,0,0,0,0,0,0,0,0,1,0,0,0,0,0,0,0,1,1,1,0,0,0,1,1,0,1,2,2,0,0,0,0,0,0,0,0,0,1,3,4,3,3,2,2,3,4,5,3,3,4,6,6,10,11,8,5,3,2,3,3,4,8,8,4,0,0
0,0,0,0,0,0,0,0,0,0,0,0,0,0,0,0,0,1,2,1,1,2,4,3,1,0,0,0,0,0,0,0,0,0,0,0,0,0,0,0,0,0,0,0,0,0,0,0,0,0,0,0,0,0,0,0,0,1,0,1,2,1,0,0,0,0,0,0,0,0,0,0,1,3,3,3,2,1,1,2,3,2,2,4,5,6,7,9,10,8,5,3,4,4,5,8,8,3,0,0
0,0,0,0,0,0,0,0,0,0,0,0,0,0,0,0,0,1,1,0,0,0,1,1,0,0,0,0,0,0,0,0,0,0,0,0,0,0,0,0,0,0,0,0,0,0,0,0,0,0,0,0,0,0,0,0,0,0,0,0,0,0,0,0,0,0,0,0,0,0,0,0,1,2,2,3,3,3,1,1,2,2,2,3,5,6,6,10,12,12,10,8,8,8,8,7,6,2,0,0
0,0,0,0,0,0,0,0,0,0,0,0,3,4,2,0,0,0,1,2,1,0,0,0,1,1,1,1,1,2,1,1,1,1,1,0,0,0,0,0,0,0,0,0,0,0,0,0,0,0,0,0,0,1,1,0,0,0,0,0,0,0,2,2,0,0,0,0,0,0,0,1,2,2,1,2,5,5,4,3,7,9,8,6,7,7,7,10,13,13,11,10,8,8,10,11,9,3,0,0
0,0,0,0,0,0,0,0,0,0,0,1,4,6,3,0,0,1,3,3,2,1,1,1,1,2,1,2,3,5,3,2,2,2,2,1,0,0,0,0,0,0,0,0,0,0,0,0,0,0,0,1,1,1,1,0,0,0,0,0,0,1,3,3,1,0,0,0,0,0,0,1,2,1,0,2,5,7,8,9,13,14,12,10,10,8,7,9,11,11,9,8,5,4,7,12,12,5,0,0
0,0,0,0,0,0,0,0,0,0,0,1,3,4,2,0,0,1,2,3,1,1,1,0,1,1,1,1,4,5,3,1,1,1,1,1,1,0,0,0,0,0,0,0,0,0,0,0,0,0,0,0,0,1,1,0,0,1,0,0,0,0,2,2,0,0,0,0,0,0,0,2,1,1,1,3,4,6,12,17,17,13,11,12,11,8,7,9,12,12,8,6,5,5,5,10,12,6,0,0
0,0,0,0,0,0,0,0,0,0,0,1,0,0,0,0,0,0,1,0,0,1,0,0,0,0,0,1,2,2,1,0,0,0,0,1,1,0,0,0,0,0,0,0,0,0,0,0,0,0,0,0,0,0,0,0,0,0,0,0,0,0,0,0,0,0,0,0,0,0,1,2,2,2,4,4,3,5,14,19,16,10,11,15,13,8,7,10,14,14,9,5,5,6,5,9,10,6,0,0
0,0,0,0,0,0,0,0,0,0,1,1,0,0,0,0,0,0,0,0,0,0,0,0,0,1,1,2,2,1,0,0,0,0,0,1,1,0,0,0,0,0,0,0,0,0,0,0,0,0,0,0,0,0,0,0,1,0,0,0,0,0,1,0,0,0,0,0,0,0,1,1,1,2,3,3,4,7,13,18,15,10,12,16,16,12,9,11,15,15,9,3,4,5,6,10,11,6,0,0
0,0,0,0,0,0,0,0,0,0,1,0,0,0,0,0,0,0,0,0,0,0,0,1,1,1,2,3,4,2,0,0,0,0,0,0,0,0,0,0,0,0,0,0,0,0,0,0,0,0,0,0,0,0,0,1,2,1,0,0,0,0,0,0,0,0,0,0,0,0,1,2,1,1,1,2,6,11,14,14,13,11,10,13,17,16,13,12,16,13,8,4,2,2,4,9,10,5,0,0
0,0,0,0,0,0,0,0,0,1,1,0,0,0,0,0,0,0,0,0,0,0,0,0,0,1,1,3,4,2,0,0,0,0,0,1,0,0,0,0,0,0,0,0,0,0,0,0,0,0,0,1,0,0,0,0,1,0,0,0,0,0,0,0,0,0,0,0,0,0,1,5,9,8,7,9,11,14,15,15,13,13,10,11,14,15,15,19,20,17,12,9,7,7,9,13,11,4,0,0
0,0,0,0,0,0,0,0,2,1,0,0,0,0,0,0,0,0,0,0,0,0,0,0,0,0,0,1,2,1,0,0,0,0,0,1,0,0,0,0,0,0,0,0,0,0,0,0,0,0,0,0,0,0,0,0,0,0,0,0,0,0,0,0,0,0,0,0,0,0,3,16,25,25,17,14,12,15,15,14,13,13,12,12,12,12,16,20,23,20,17,16,15,11,12,19,18,7,0,0
0,0,0,0,0,0,0,1,2,2,0,0,0,0,0,0,0,0,0,0,0,0,0,0,0,0,0,0,0,0,0,0,0,0,0,1,0,0,0,1,0,0,1,0,0,0,0,0,0,0,0,0,1,1,0,0,0,0,0,0,0,0,1,0,0,0,0,0,0,0,8,26,36,30,18,11,10,12,16,17,15,12,13,14,17,17,15,17,23,23,18,18,20,17,16,27,27,13,0,0
0,0,0,0,0,0,0,0,1,0,0,0,0,0,0,0,0,0,0,0,0,0,0,0,1,0,0,0,0,1,0,0,1,0,1,2,1,0,0,0,0,1,2,1,0,0,0,0,0,0,0,0,1,1,0,0,0,0,0,0,0,0,0,0,0,0,0,0,0,0,10,26,31,20,10,8,11,15,20,24,20,16,17,18,21,21,16,13,22,22,15,13,17,17,16,37,46,25,0,0
0,0,0,0,0,0,0,0,0,0,0,0,0,0,0,0,0,0,0,0,1,1,0,0,0,0,0,0,0,0,0,0,0,0,1,2,1,0,0,0,0,0,1,0,0,0,0,0,0,0,0,0,0,0,0,0,0,0,0,0,0,0,0,0,0,0,0,0,0,0,8,18,18,8,5,10,17,20,22,24,22,20,19,20,21,22,16,21,29,28,17,12,12,17,19,47,55,32,0,0
0,0,0,0,0,0,0,0,0,0,0,0,0,0,0,0,0,0,1,1,1,0,0,0,0,0,0,0,0,0,0,0,0,0,0,1,0,0,0,0,0,0,0,0,0,0,0,0,0,0,0,0,0,0,0,0,0,0,0,0,0,0,0,0,0,0,0,0,0,0,5,11,11,4,4,10,17,19,17,18,19,21,21,21,20,20,22,28,33,33,25,17,13,15,17,37,46,25,0,0
0,0,0,0,1,1,0,0,0,0,0,0,0,0,0,0,0,0,1,1,0,0,0,0,0,0,0,0,0,0,0,0,0,0,0,0,0,0,0,0,0,0,0,0,0,0,0,0,0,0,0,0,0,0,0,0,0,0,0,0,0,0,1,0,0,0,0,0,0,0,4,9,9,5,4,8,10,13,13,13,18,22,24,21,20,23,29,27,27,29,27,19,14,14,12,21,25,14,0,0
0,0,0,0,1,1,0,0,0,0,0,0,0,0,0,1,0,0,0,0,0,0,0,0,0,0,0,0,0,0,0,0,1,1,0,0,0,0,0,0,0,0,0,0,0,0,0,0,0,0,0,0,0,0,0,0,0,0,0,0,0,1,2,1,0,0,0,0,0,0,5,10,9,6,5,5,8,17,24,23,22,26,29,22,19,25,32,25,16,18,19,13,9,7,5,13,18,11,0,0
0,0,0,0,0,0,0,1,1,1,0,0,1,0,0,0,0,0,0,0,0,0,0,0,0,0,0,0,1,0,0,0,1,1,0,0,0,0,0,0,0,0,0,0,0,0,0,0,0,0,0,0,0,0,0,0,0,0,0,0,0,1,2,1,0,0,0,0,0,0,32,66,60,33,29,30,35,40,43,36,29,32,33,24,19,28,36,42,53,64,66,54,40,32,32,58,68,33,0,0
0,0,0,0,0,0,0,0,0,0,0,0,0,0,0,0,0,0,0,0,0,0,0,0,0,0,0,0,0,0,0,0,0,0,0,0,0,0,0,0,0,0,0,0,0,0,0,0,0,0,0,0,0,0,0,0,0,0,0,0,0,0,1,0,0,0,0,0,0,0,50,90,89,48,42,45,48,46,40,32,27,39,47,35,25,32,42,56,73,90,92,78,60,49,49,84,86,48,0,0
0,0,0,0,0,0,0,0,0,0,0,0,0,0,0,0,0,0,0,0,0,0,0,0,0,0,0,0,1,0,0,0,0,0,0,0,0,0,0,0,0,0,0,0,0,0,0,0,0,0,0,0,0,0,0,0,0,0,0,0,0,0,0,0,0,0,0,0,0,0,27,58,52,29,25,28,28,22,15,12,17,36,54,50,35,34,39,41,47,54,56,47,36,30,29,49,55,26,0,0
0,0,0,0,0,0,0,0,0,0,0,0,0,0,0,0,0,0,0,0,0,0,0,0,0,0,0,1,2,1,0,0,0,0,0,0,0,0,0,0,0,0,0,0,0,0,0,0,0,0,0,0,0,0,0,0,0,0,0,0,0,0,0,0,0,0,0,0,0,0,0,0,0,0,0,0,0,0,0,0,6,22,45,49,42,32,29,18,5,0,0,0,0,0,0,0,0,0,0,0
0,0,0,0,0,0,0,0,0,0,0,0,0,0,0,0,0,0,0,0,0,0,0,0,0,0,0,0,1,0,0,0,0,0,0,0,0,0,0,0,0,0,0,0,0,0,0,0,0,0,0,0,0,0,0,0,0,0,0,0,0,0,0,0,0,0,0,0,0,0,0,0,0,0,0,0,0,0,0,0,5,11,25,36,38,28,23,14,6,0,0,0,0,0,0,0,0,0,0,0
0,0,0,0,0,0,0,0,0,0,0,0,0,0,0,0,0,0,0,0,0,0,0,0,0,0,0,0,0,0,0,0,0,0,0,0,0,0,0,0,0,0,0,0,0,0,0,0,0,0,0,0,0,0,0,0,0,0,0,0,0,0,0,0,0,0,0,0,0,0,0,0,0,0,0,0,0,0,0,0,4,10,18,29,36,28,20,13,7,0,0,0,0,0,0,0,0,0,0,0
0,0,0,0,0,0,0,0,0,0,0,0,0,0,0,0,0,0,0,0,0,0,0,0,0,0,0,0,0,0,0,0,0,0,0,0,0,0,0,0,0,0,0,0,0,0,0,0,0,0,0,0,0,0,0,0,0,0,0,0,0,0,0,0,0,0,0,0,0,0,0,0,0,0,0,0,0,0,0,0,2,7,15,29,35,27,16,13,8,4,2,0,0,0,0,0,0,0,0,0
0,0,0,0,0,0,0,0,0,0,0,0,0,0,0,0,0,0,0,0,0,0,0,0,0,0,0,0,0,0,0,0,0,0,0,0,0,0,0,0,0,0,0,0,0,0,0,0,0,0,0,0,0,0,0,0,0,0,0,0,0,0,0,0,0,0,2,3,2,0,0,0,0,0,0,0,0,0,0,0,0,4,12,27,34,26,15,12,10,6,3,0,0,0,0,0,0,0,0,0
0,0,0,0,0,0,0,0,0,0,0,0,0,0,0,0,0,0,0,0,0,0,0,0,0,0,0,0,0,0,0,0,0,0,0,0,0,1,0,0,0,0,0,0,0,2,4,2,0,0,0,0,0,0,0,0,0,0,0,0,0,0,0,0,1,1,4,5,3,0,0,0,0,0,0,0,0,0,0,0,0,2,10,23,30,24,14,10,9,7,3,0,0,0,0,0,0,0,0,0
0,0,0,0,0,0,0,0,0,0,0,0,0,0,0,0,0,0,0,0,0,0,0,0,0,0,0,0,0,0,0,0,0,0,0,0,1,2,1,0,0,0,0,0,0,5,7,5,0,0,0,0,0,0,0,0,0,0,0,0,0,0,0,1,2,2,5,8,4,0,0,0,0,0,0,0,0,0,0,0,0,2,10,20,27,23,14,9,9,7,4,0,0,0,0,0,0,0,0,0
0,0,0,0,0,0,0,0,0,0,0,0,0,0,0,0,0,0,0,0,0,0,0,0,0,0,0,0,0,0,0,0,0,0,0,0,0,1,0,0,0,0,0,0,0,5,9,5,0,0,0,0,0,0,0,0,0,0,0,0,0,0,0,0,1,2,9,12,6,0,0,0,0,0,0,0,0,0,0,0,0,1,8,19,26,20,12,8,10,9,6,1,0,0,0,0,0,0,0,0
0,0,0,0,0,0,0,0,0,0,0,0,0,0,0,0,0,0,0,0,0,0,0,0,0,0,0,0,0,1,1,0,0,0,0,0,0,0,0,1,1,0,0,0,0,4,7,4,0,0,0,0,0,0,0,0,0,0,0,0,0,0,0,0,1,3,11,14,8,0,0,0,0,0,0,0,0,1,0,0,0,1,6,16,25,22,13,7,8,8,7,3,0,0,0,0,0,0,0,0
0,0,0,0,0,0,0,0,0,0,0,0,0,0,0,0,0,0,0,0,0,0,0,0,0,0,0,0,1,2,2,1,1,1,0,0,1,0,0,1,1,0,0,1,0,4,7,4,0,0,0,0,0,0,0,0,0,0,0,1,1,0,0,1,3,5,10,11,6,0,0,0,0,0,1,0,0,0,0,0,0,1,6,15,25,22,13,6,6,8,8,5,1,0,0,0,0,0,0,0
0,0,0,0,0,0,0,0,0,0,0,0,0,0,0,0,0,0,0,0,0,0,0,0,0,0,0,0,0,1,1,0,0,0,0,0,0,0,0,0,0,0,0,1,1,4,6,4,0,0,0,0,0,0,1,1,1,1,1,2,2,1,2,2,3,5,8,7,3,0,0,0,0,0,0,0,0,0,0,0,0,2,7,14,21,20,12,7,8,10,9,5,1,0,0,0,0,0,0,0
0,0,0,0,0,0,0,0,0,0,0,0,0,0,0,0,0,0,0,1,0,0,0,0,0,0,0,0,0,0,0,0,0,0,0,0,0,0,0,0,0,0,0,0,1,4,6,4,0,0,0,0,2,2,2,2,2,1,1,2,2,1,2,3,2,2,6,7,3,0,0,0,0,0,0,0,0,0,0,1,1,2,7,14,19,17,10,8,8,11,9,5,0,0,0,0,0,0,0,0
0,0,0,0,0,0,0,0,0,0,0,0,0,0,0,0,0,0,1,2,1,0,1,0,0,0,0,0,0,0,0,0,0,0,0,0,0,0,0,0,0,0,0,0,0,3,5,5,3,3,3,3,3,4,3,2,2,1,1,1,1,0,1,2,2,2,6,7,4,0,0,0,1,0,0,0,0,0,0,0,1,2,6,13,16,16,13,9,6,8,7,5,2,0,0,0,0,0,0,0
0,0,0,0,0,0,0,0,0,0,0,0,0,0,0,0,0,0,0,1,0,0,0,0,0,0,0,0,1,0,0,0,0,0,0,0,0,0,0,0,0,0,0,0,0,1,5,7,7,7,5,3,3,3,2,1,0,0,0,0,0,0,0,2,2,3,7,9,4,0,0,0,0,0,0,0,0,0,0,0,0,1,5,13,18,18,15,10,5,5,7,7,4,1,0,0,0,0,0,0
0,0,0,0,0,0,0,0,0,0,0,0,0,0,0,0,0,0,0,0,0,0,0,0,0,0,0,0,0,0,0,0,0,1,1,0,0,0,1,1,0,0,0,0,0,1,5,7,7,5,5,2,1,1,1,0,0,0,0,0,0,0,1,2,2,2,7,9,5,0,0,0,0,0,0,0,0,0,0,0,0,1,5,12,16,17,15,10,6,5,7,8,6,2,1,0,0,0,0,0
0,0,0,0,0,0,0,0,0,0,0,0,0,0,0,0,0,0,0,0,0,0,0,0,0,0,0,1,0,0,1,0,0,1,1,0,0,0,1,1,0,0,0,0,1,2,5,5,3,1,1,1,1,1,1,0,1,1,1,1,2,2,2,2,2,2,7,10,8,3,2,2,1,2,3,2,1,2,2,1,0,2,5,11,15,16,13,10,6,7,8,9,6,2,1,0,0,0,0,0
0,0,0,0,0,0,0,0,0,0,0,0,0,0,0,0,0,0,0,0,0,0,0,0,0,0,1,2,1,0,0,0,0,0,0,0,0,0,1,1,0,0,0,0,1,2,4,4,2,0,1,2,1,0,1,0,1,1,1,2,3,3,2,1,2,3,8,11,10,5,5,4,2,2,4,3,3,4,3,2,2,4,5,10,12,14,12,10,6,7,10,10,7,3,2,1,0,0,0,0
0,0,0,0,0,0,0,0,0,0,0,0,0,0,0,0,0,0,0,0,0,0,0,0,0,0,0,1,0,0,0,0,0,0,0,0,0,0,0,0,0,0,0,0,0,2,5,4,2,1,1,1,0,0,0,0,0,0,0,1,3,3,2,1,3,4,7,9,8,4,3,3,1,1,2,2,2,2,2,2,5,9,8,11,12,15,13,11,7,7,9,10,9,6,5,3,2,0,0,0
0,0,0,0,0,0,0,0,0,0,0,0,0,0,0,0,0,0,0,0,0,0,0,0,0,0,0,0,0,0,0,0,0,0,0,0,0,0,0,0,0,0,0,0,0,2,4,4,2,1,1,0,0,0,0,0,0,0,0,0,1,2,2,2,3,4,6,6,4,1,1,0,1,1,1,1,2,3,3,5,8,12,10,10,11,13,11,11,8,8,10,11,9,7,7,5,3,0,0,0
0,0,0,0,0,0,0,0,1,0,0,0,0,0,0,0,0,0,0,0,0,0,0,0,0,0,0,0,0,0,0,0,0,0,0,0,0,0,0,0,0,0,0,0,1,3,5,3,1,0,0,0,0,1,1,0,0,0,0,0,0,1,1,2,3,4,6,5,4,3,3,3,4,4,4,4,6,8,10,11,11,13,12,10,11,14,12,11,10,12,13,12,9,6,5,6,6,2,0,0
0,0,0,0,0,0,0,1,2,1,0,0,0,0,0,0,0,0,0,0,0,0,0,0,0,0,0,0,0,0,1,0,0,1,0,0,1,0,0,0,1,0,0,1,2,4,4,3,0,0,0,0,0,0,1,1,0,0,1,0,0,0,1,1,2,4,6,6,7,7,6,6,6,5,5,4,6,9,13,15,15,16,12,11,13,17,17,16,16,16,16,12,8,6,6,10,9,5,0,0
0,0,0,0,0,0,0,0,1,0,0,0,0,0,0,0,0,0,0,0,0,0,0,0,0,0,2,1,0,0,0,0,0,0,0,0,0,0,0,0,0,0,0,1,3,6,6,3,0,0,0,0,0,0,0,0,0,0,1,1,0,0,1,1,2,5,10,13,12,8,7,5,4,4,3,3,3,6,10,13,17,18,16,14,17,21,23,21,19,17,16,12,9,8,11,18,18,7,0,0
0,0,0,0,0,0,0,0,0,0,0,1,0,0,0,0,0,0,0,0,0,0,0,0,0,1,2,2,0,0,0,0,0,0,0,0,0,0,0,0,0,0,0,0,3,7,8,4,0,0,0,0,0,0,0,0,0,0,1,2,1,1,1,1,3,9,17,18,12,6,4,3,3,2,1,1,1,3,5,9,14,20,20,20,21,23,22,22,22,20,20,18,14,9,13,22,23,10,0,0
0,0,0,0,0,0,0,0,0,0,0,0,0,0,0,0,1,0,0,0,0,0,0,0,0,0,1,0,0,0,0,0,0,0,0,0,0,0,0,0,0,0,0,0,1,8,10,5,0,0,0,0,0,0,0,0,0,0,1,2,2,3,3,2,3,11,16,14,6,1,3,4,3,1,1,0,0,2,5,7,12,19,22,23,23,27,26,26,23,22,23,23,16,10,11,24,25,12,0,0
0,0,0,0,0,0,0,0,0,0,0,0,0,0,0,0,0,0,0,0,0,0,0,0,0,0,0,0,0,0,0,0,0,0,0,0,0,0,0,1,0,0,0,0,1,7,11,6,0,0,0,0,0,0,0,0,0,0,0,1,2,4,4,2,2,9,13,8,1,0,4,6,4,0,0,0,0,1,4,6,9,13,14,16,22,30,31,29,23,19,17,16,12,11,12,21,23,12,0,0
0,0,0,0,0,0,0,0,0,0,0,0,0,0,0,0,0,0,0,0,0,0,1,0,0,0,0,1,0,0,0,0,0,0,0,0,1,1,1,1,1,0,0,1,1,7,10,7,0,0,0,0,0,0,0,0,0,0,0,0,2,5,4,1,0,6,11,9,2,0,5,8,6,1,1,0,1,2,5,5,6,6,8,12,22,31,30,24,16,11,9,7,7,11,13,22,23,12,0,0
0,0,0,0,0,0,0,0,0,0,0,0,0,0,0,0,0,0,0,0,0,1,1,0,0,0,0,0,0,0,0,0,0,0,0,1,2,2,1,0,1,1,1,1,0,8,12,7,0,0,0,0,0,0,0,0,0,0,0,0,2,3,3,2,0,4,11,11,4,0,4,8,6,2,2,3,5,4,5,6,9,10,11,12,23,30,28,20,17,14,11,7,8,10,11,19,22,12,0,0
0,0,0,0,0,0,0,0,0,0,0,0,0,0,1,0,0,1,0,0,0,1,0,0,0,0,0,0,0,0,0,0,0,0,0,0,1,1,0,0,1,2,2,2,0,11,18,11,0,0,0,0,0,0,0,1,1,0,0,1,3,5,5,3,1,5,21,25,12,0,7,15,14,13,22,29,26,20,22,27,26,21,18,16,21,30,28,23,32,45,52,51,46,32,26,57,70,35,0,0
0,0,0,0,0,0,0,0,0,0,0,0,0,1,2,1,0,0,0,0,0,0,0,0,0,0,0,1,0,0,0,0,0,1,0,0,0,0,0,0,1,1,2,2,1,11,17,10,0,0,0,0,0,0,1,2,2,1,1,1,3,5,5,3,1,6,25,29,15,0,9,17,19,19,33,41,37,28,32,39,42,32,23,18,21,28,32,36,50,62,71,74,64,44,34,77,85,50,0,0
0,0,0,0,0,0,0,0,0,0,0,0,0,0,1,0,0,0,0,0,0,0,0,0,0,0,0,0,0,0,0,0,0,0,0,0,0,0,0,0,0,0,1,1,0,5,8,4,0,0,0,0,0,0,0,1,1,0,0,1,2,3,3,1,0,3,13,16,7,0,5,10,10,11,19,24,21,16,18,29,35,32,24,22,26,31,36,41,43,42,40,43,38,25,20,44,54,27,0,0
0,0,0,0,0,0,0,0,0,0,0,0,0,0,0,0,0,0,0,0,0,0,0,0,0,0,0,0,0,0,0,0,0,0,0,0,0,0,0,0,0,0,0,0,0,0,0,0,0,0,0,0,0,0,0,0,0,0,0,0,0,0,0,0,0,0,0,0,0,0,0,0,0,0,0,0,0,0,0,4,16,20,19,18,23,28,31,30,20,6,0,0,0,0,0,0,0,0,0,0
0,0,0,0,0,0,0,0,0,0,0,0,0,0,0,0,0,0,0,0,0,0,0,0,0,0,0,0,0,0,0,0,0,0,0,0,0,0,0,0,0,0,0,0,0,0,0,0,0,0,0,0,0,0,0,0,0,0,0,0,0,0,0,0,0,0,0,0,0,0,0,0,0,0,0,0,0,0,0,0,3,8,9,9,13,16,16,10,3,0,0,0,0,0,0,0,0,0,0,0
